aaa	taken
aab	taken
aac	taken
aad	taken
aae	taken
aah	taken
aaj	taken
aai	taken
aaf	taken
aag	taken
aak	taken
aan	taken
aal	taken
aap	taken
aaq	taken
aam	taken
aas	taken
aat	taken
aao	taken
aar	taken
aau	taken
aav	taken
aaw	taken
aax	taken
aay	taken
aaz	taken
abb	taken
abc	taken
abe	taken
abj	taken
abi	taken
abn	taken
abd	free
abo	taken
abf	free
abp	taken
abq	taken
abs	taken
abl	free
aba	free
abg	free
abu	taken
abh	free
abv	taken
abk	free
abm	free
abt	free
acc	taken
abw	taken
abr	free
aby	taken
abz	taken
ace	taken
acf	taken
acg	taken
ach	taken
ack	taken
acl	taken
acn	taken
acm	taken
aco	taken
acp	taken
aca	free
acd	free
acs	taken
acj	free
act	taken
abx	free
acy	taken
acb	free
ada	taken
adb	taken
aci	free
acu	free
adc	taken
add	taken
acx	free
acz	free
adf	taken
acq	free
adh	taken
acr	free
adi	taken
acv	free
adl	taken
adm	taken
acw	free
adk	taken
adn	taken
adp	taken
adg	free
adq	taken
adr	taken
ads	taken
adt	taken
adv	taken
ade	free
aec	taken
adj	free
aed	taken
adw	free
adx	free
ady	free
aeb	free
ado	free
adu	free
adz	free
aea	free
aee	free
aeg	free
aei	free
aeh	free
aeo	taken
aek	free
aes	taken
ael	free
aef	free
aem	free
aen	free
aej	free
aeq	free
aep	free
aet	free
afc	taken
aev	free
aer	free
afd	taken
afe	taken
aex	free
aff	taken
aez	free
aew	free
afa	free
aeu	free
afk	taken
afm	taken
afn	taken
aey	free
afp	taken
afb	free
afh	free
afi	free
afj	free
afs	taken
aft	taken
afw	taken
afo	free
afg	free
afq	free
afr	free
afl	free
afu	free
afv	free
agd	taken
age	taken
agf	taken
agg	taken
aga	free
agi	taken
agc	free
agl	taken
afy	free
afx	free
ago	taken
afz	free
agh	free
agb	free
agj	free
ags	taken
agt	taken
agk	free
agu	taken
agp	free
agq	free
agr	free
aha	taken
agm	free
agv	free
agn	free
agx	free
ahd	taken
agz	free
ahi	taken
agw	free
agy	free
ahj	free
ahb	free
ahc	free
ahf	free
ahe	free
ahg	free
ahp	taken
ahh	free
ahr	taken
ahk	free
ahl	free
ahn	free
aho	free
ahm	free
aht	free
ahu	free
ahq	free
aia	taken
ahv	free
ahs	free
aid	taken
aig	taken
ahx	free
ahw	free
aib	free
ahz	free
aie	free
aik	taken
aif	free
aim	taken
ahy	free
ain	taken
aio	taken
aii	free
air	taken
aic	free
aij	free
aiq	taken
ais	taken
aih	free
aja	taken
ait	free
aiv	free
ail	free
aiw	free
aix	free
aiy	free
ajc	taken
ajd	taken
aip	free
ajf	taken
aji	taken
aiu	free
aiz	free
ajb	free
ajh	free
ajj	free
aje	free
ajr	taken
ajg	free
ajs	taken
ajt	taken
ajv	taken
ajp	free
ajk	free
ajl	free
ajq	free
ajm	free
ajx	taken
ajn	free
aka	taken
akb	taken
ajo	free
ake	taken
ajw	free
akh	taken
aki	taken
ajy	free
ajz	free
akc	free
aju	free
akk	taken
akg	free
ako	taken
aks	taken
akj	free
akd	free
akt	taken
akm	free
aku	taken
akf	free
akv	taken
akp	free
akq	free
ala	taken
alb	taken
akn	free
akl	free
ale	taken
alf	taken
alg	taken
akw	free
akr	free
ali	taken
alk	taken
all	taken
alm	taken
alo	taken
akx	free
ald	free
alp	taken
aky	free
akz	free
alh	free
alc	free
als	taken
alt	taken
alu	taken
alr	free
alx	taken
aly	taken
aln	free
ama	taken
amb	taken
amd	taken
alq	free
ame	taken
alj	free
amf	taken
amg	taken
ami	taken
aml	taken
amm	taken
alz	free
amo	taken
amc	free
amp	taken
amq	taken
alv	free
alw	free
amr	taken
ams	taken
amt	taken
amj	free
amk	free
amx	taken
amy	taken
amh	free
amz	taken
ana	taken
and	taken
amn	free
ane	taken
ang	taken
ani	taken
ank	taken
amu	free
amv	free
amw	free
anc	free
anb	free
anm	taken
ann	taken
ano	taken
anh	free
anf	free
ans	taken
ant	taken
anj	free
anu	taken
anx	taken
anw	taken
any	taken
aob	taken
anp	free
aoc	taken
anl	free
anr	free
aoe	taken
aof	taken
anv	free
aoi	taken
aok	taken
aol	taken
aom	taken
anq	free
aod	free
aop	taken
aog	free
aoa	free
anz	free
aos	taken
aon	free
aoh	free
aow	taken
aoj	free
aoy	taken
aor	free
apa	taken
apb	taken
apc	taken
aoo	free
aov	free
aoq	free
apg	taken
ape	taken
aox	free
api	taken
aph	taken
aoz	free
aot	free
aou	free
apl	taken
apm	taken
app	taken
apn	taken
apr	taken
aps	taken
apt	taken
apu	taken
apv	taken
apk	free
apw	taken
apx	taken
apd	free
apy	taken
apf	free
apq	free
aqb	taken
apj	free
apo	free
aqi	taken
aqa	free
apz	free
aqd	free
aqe	free
aqg	free
aql	taken
aqh	free
aqr	taken
aqc	free
aqj	free
aqf	free
aqk	free
aqo	free
aqn	free
aqp	free
aqq	free
aqm	free
ara	taken
aqt	free
aqu	free
aqv	free
arc	taken
ard	taken
are	taken
arf	taken
arg	taken
aqx	free
aqy	free
aqs	free
ari	taken
aqw	free
ark	taken
arl	taken
arm	taken
arn	taken
arb	free
aqz	free
arp	taken
arq	taken
arr	taken
art	taken
aru	taken
ars	taken
arx	taken
arj	free
ary	taken
asa	taken
asc	taken
asd	taken
ase	taken
asf	taken
arh	free
asg	taken
ash	taken
ask	taken
asl	taken
aro	free
asm	taken
aso	taken
asp	taken
asq	taken
asr	taken
asi	free
arw	free
arv	free
ass	taken
asb	free
arz	free
ast	taken
asv	taken
asy	taken
asx	taken
atc	taken
ate	taken
asj	free
asn	free
atf	taken
atj	taken
asu	free
atk	taken
asw	free
atb	free
atl	taken
asz	free
ata	free
atm	taken
atd	free
ato	taken
atp	taken
atr	taken
ats	taken
att	taken
atg	free
ath	free
ati	free
atn	free
atq	free
aty	free
atz	free
aua	free
aub	free
atu	free
atv	free
auc	free
atx	free
aug	taken
atw	free
aud	free
aui	taken
aul	taken
auk	taken
aum	taken
aup	taken
aue	free
aur	taken
aus	taken
auf	free
aut	taken
auh	free
auv	taken
aux	taken
ava	taken
auo	free
auq	free
auu	free
auj	free
ave	taken
auw	free
aun	free
avg	taken
auy	free
avb	free
avl	taken
avd	free
avm	taken
avn	taken
avo	taken
auz	free
avc	free
avr	taken
avk	free
avs	taken
avf	free
avh	free
avi	free
avj	free
avq	free
avt	free
awa	taken
avu	free
avp	free
awc	taken
awe	taken
awf	taken
avv	free
avw	free
avy	free
avx	free
awk	taken
awd	free
avz	free
awl	taken
awm	taken
awb	free
awp	taken
awi	free
aws	taken
awj	free
awg	free
awh	free
awo	free
awn	free
aww	free
awq	free
awr	free
axa	taken
awy	free
awu	free
awt	free
awz	free
awv	free
axe	taken
awx	free
axb	free
axc	free
axm	taken
axn	taken
axi	free
axj	free
axo	taken
axk	free
axd	free
axl	free
axs	taken
axf	free
axg	free
axt	taken
axh	free
aya	taken
axq	free
axp	free
axr	free
axv	free
ayb	taken
aye	taken
axz	free
axu	free
axw	free
axx	free
axy	free
ayd	free
ayi	free
ayh	free
ayn	taken
ayc	free
ayo	taken
ayj	free
ayf	free
ayg	free
ayl	free
ayk	free
aym	free
ayu	taken
ayy	taken
ayp	free
ayr	free
ayt	free
ayq	free
ayw	free
ays	free
aze	taken
ayv	free
ayx	free
ayz	free
aza	free
azb	free
azc	free
azg	free
azd	free
azf	free
azk	free
azh	free
azi	free
azm	free
azn	free
azo	free
azj	free
azt	taken
azx	taken
azl	free
azy	taken
baa	taken
bab	taken
bac	taken
azp	free
azs	free
bad	taken
azu	free
azw	free
azq	free
baf	taken
bae	taken
bag	taken
azr	free
bai	taken
bah	taken
bak	taken
azv	free
bam	taken
ban	taken
bao	taken
bap	taken
bar	taken
bas	taken
bat	taken
bau	taken
azz	free
bba	taken
bay	taken
baz	taken
bbb	taken
bbc	taken
bal	free
bav	free
baj	free
bax	free
baq	free
bbk	taken
bbf	free
baw	free
bbg	free
bbl	taken
bbh	free
bbm	taken
bbp	taken
bbi	free
bbe	free
bbd	free
bbq	taken
bbj	free
bbs	taken
bbt	taken
bca	taken
bbo	free
bbn	free
bcc	taken
bcd	taken
bbu	free
bce	taken
bch	taken
bbr	free
bcb	free
bbv	free
bbx	free
bby	free
bbz	free
bbw	free
bcn	taken
bco	taken
bcg	free
bcp	taken
bci	free
bcs	taken
bcj	free
bck	free
bcf	free
bcu	taken
bcq	free
bct	free
bcl	free
bcm	free
bcv	free
bcw	free
bdd	taken
bcy	free
bcr	free
bde	taken
bdf	taken
bdi	taken
bcx	free
bcz	free
bdb	free
bdo	taken
bda	free
bdk	free
bdj	free
bdp	taken
bdc	free
bdq	taken
bdl	free
bdt	taken
bdg	free
bdm	free
bdh	free
bea	taken
bdn	free
bdr	free
bdw	free
bdx	free
bdy	free
bdz	free
bed	taken
bee	taken
bds	free
beg	taken
bdv	free
bei	taken
bdu	free
bel	taken
bem	taken
ben	taken
beo	taken
beb	free
bes	taken
beh	free
bet	taken
bej	free
bek	free
bec	free
bev	taken
bex	taken
bez	taken
bef	free
beq	free
ber	free
bfc	taken
bff	taken
bfg	taken
bep	free
bew	free
bfi	taken
bfj	taken
beu	free
bfm	taken
bey	free
bfh	free
bfa	free
bfb	free
bfe	free
bfd	free
bfs	taken
bfn	free
bfk	free
bfl	free
bfu	free
bfo	free
bfp	free
bfq	free
bfr	free
bfw	free
bfv	free
bft	free
bgg	taken
bga	free
bfx	free
bgc	free
bgd	free
bge	free
bfy	free
bfz	free
bgf	free
bgm	taken
bgb	free
bgh	free
bgj	free
bgl	free
bgt	taken
bgp	free
bgq	free
bgi	free
bgk	free
bgn	free
bgo	free
bgu	free
bgr	free
bgv	free
bgs	free
bhd	taken
bgy	free
bhb	free
bgw	free
bgx	free
bgz	free
bhf	free
bha	free
bhg	free
bhc	free
bhe	free
bhp	taken
bhj	free
bhk	free
bhh	free
bhm	free
bhn	free
bhi	free
bhq	free
bhl	free
bho	free
bht	free
bhu	free
bia	taken
bhr	free
bib	taken
bic	taken
bhs	free
bid	taken
bif	taken
big	taken
bhy	free
bhv	free
bii	taken
bhw	free
bim	taken
bhx	free
bin	taken
bio	taken
bhz	free
bis	taken
bip	taken
bir	taken
bit	taken
biu	taken
bix	taken
bie	free
bih	free
biz	taken
bik	free
bil	free
bij	free
biq	free
biv	free
biy	free
biw	free
bjc	free
bjg	free
bjh	free
bja	free
bjb	free
bjd	free
bje	free
bjf	free
bjk	free
bji	free
bjs	taken
bjm	free
bjj	free
bjp	free
bjl	free
bjn	free
bjo	free
bjt	free
bjq	free
bjr	free
bju	free
bkb	taken
bjy	free
bjv	free
bkg	taken
bjw	free
bka	free
bjx	free
bkk	taken
bke	free
bkd	free
bjz	free
bkf	free
bkm	taken
bkn	taken
bkp	taken
bkr	taken
bkc	free
bks	taken
bkh	free
bki	free
bkj	free
bkt	free
bkl	free
bko	free
bla	taken
bkq	free
blc	taken
bld	taken
bkv	free
ble	taken
bku	free
bkw	free
bkz	free
blg	taken
blk	taken
blm	taken
bkx	free
bky	free
blo	taken
blf	free
blq	taken
blb	free
bls	taken
blt	taken
bll	free
blu	taken
bly	taken
blh	free
blp	free
blj	free
bli	free
blz	taken
bmc	taken
bmd	taken
bln	free
blw	free
blx	free
bmi	taken
bma	free
blr	free
blv	free
bmm	taken
bmf	free
bmh	free
bmo	taken
bmp	taken
bmb	free
bmq	taken
bme	free
bms	taken
bmg	free
bmv	taken
bmw	taken
bmn	free
bmj	free
bmx	taken
bmk	free
bml	free
bna	taken
bmr	free
bnc	taken
bmu	free
bnd	taken
bnf	taken
bmy	free
bmt	free
bnm	taken
bne	free
bng	free
bnh	free
bni	free
bmz	free
bnk	free
bnb	free
bnr	taken
bnl	free
bnt	taken
bnw	taken
bnj	free
bnn	free
bno	free
boa	taken
bob	taken
bnv	free
bnu	free
bnx	free
bnp	free
bnq	free
bny	free
bog	taken
bns	free
bnz	free
boh	taken
boi	taken
bom	taken
bok	taken
bon	taken
boo	taken
boc	free
bop	taken
bod	free
boe	free
bor	taken
bos	taken
bot	taken
bow	taken
box	taken
boy	taken
bof	free
bpb	taken
boq	free
boj	free
bol	free
bpg	taken
bpa	free
bpc	free
bpi	taken
bov	free
bou	free
bpf	free
bpe	free
bpl	taken
boz	free
bpm	taken
bpp	taken
bph	free
bpr	taken
bpd	free
bpv	taken
bpj	free
bpn	free
bpq	free
bps	free
bpu	free
bpk	free
bpo	free
bpy	free
bpt	free
bpz	free
bpw	free
bpx	free
bqc	free
bqd	free
bqa	free
bqb	free
bqg	free
bqh	free
bqe	free
bqi	free
bqf	free
bqk	free
bqq	taken
bql	free
bqm	free
bqn	free
bqj	free
bqo	free
bqp	free
bqr	free
bra	taken
bqt	free
brb	taken
bqu	free
bqw	free
bre	taken
bqs	free
bqz	free
bqv	free
bri	taken
bqx	free
brc	free
bqy	free
brd	free
brm	taken
bro	taken
brg	free
brp	taken
brt	taken
brf	free
brj	free
brk	free
brh	free
brn	free
brw	taken
brq	free
brz	taken
brr	free
brs	free
brl	free
bsa	taken
bsd	taken
bsg	taken
bru	free
bsh	taken
bsb	free
bsl	taken
bsc	free
brv	free
brx	free
bse	free
bsf	free
bry	free
bsi	free
bsj	free
bss	taken
bsk	free
bst	taken
bsw	taken
bsm	free
bso	free
bsp	free
bsq	free
btc	taken
bsv	free
bsn	free
bsr	free
bsu	free
bta	free
bsx	free
bsy	free
bsz	free
btd	free
btl	taken
btb	free
btf	free
bte	free
btg	free
bth	free
bto	free
bti	free
btr	taken
btn	free
bts	taken
btj	free
btk	free
btq	free
btw	taken
btm	free
bub	taken
btp	free
bud	taken
bue	taken
btu	free
btv	free
buf	taken
bug	taken
btz	free
buh	taken
bui	taken
buc	free
btt	free
bum	taken
bun	taken
btx	free
bty	free
bua	free
bus	taken
bur	taken
but	taken
buj	free
bux	taken
buo	free
buy	taken
bup	free
buz	taken
buk	free
buu	free
bul	free
buv	free
bvg	taken
buq	free
buw	free
bvd	free
bvf	free
bvl	taken
bvj	free
bvc	free
bva	free
bvb	free
bvm	taken
bvh	free
bve	free
bvk	free
bvi	free
bvn	free
bvp	free
bvq	free
bvu	free
bvw	free
bvo	free
bvr	free
bvs	free
bvt	free
bvv	free
bvz	free
bwa	free
bvx	free
bvy	free
bwc	free
bwe	free
bwh	free
bwg	free
bwb	free
bwd	free
bwf	free
bwl	free
bwm	free
bwr	taken
bwi	free
bwt	taken
bwj	free
bwo	free
bwn	free
bwk	free
bwp	free
bws	free
bwq	free
bww	free
bwx	free
bwy	free
bwu	free
bwv	free
bxh	taken
bxc	free
bwz	free
bxb	free
bxd	free
bxa	free
bxf	free
bxe	free
bxg	free
bxi	free
bxp	free
bxj	free
bxk	free
bxl	free
bxm	free
bxn	free
bxo	free
bxq	free
bxy	taken
bxt	free
bxs	free
bxu	free
bxr	free
bxv	free
bye	taken
bxz	free
bya	free
byg	taken
byi	taken
bxw	free
bxx	free
byb	free
byh	free
byo	taken
byc	free
byk	free
byl	free
byd	free
byp	taken
byf	free
byt	taken
byn	free
byv	taken
byj	free
bym	free
byr	free
byy	free
byz	free
byq	free
bza	free
byu	free
bys	free
byw	free
byx	free
bzd	free
bze	free
bzb	free
bzf	free
bzc	free
bzh	free
bzj	free
bzp	taken
bzg	free
bzi	free
bzl	free
bzk	free
bzo	free
bzr	free
bzm	free
bzn	free
bzz	taken
bzq	free
bzs	free
cab	taken
cac	taken
bzt	free
cad	taken
bzu	free
caf	taken
bzv	free
bzw	free
cag	taken
bzx	free
caa	free
cai	taken
cah	taken
cal	taken
cam	taken
can	taken
bzy	free
cao	taken
cap	taken
car	taken
cav	taken
caw	taken
cat	taken
cas	taken
caj	free
cae	free
cbd	taken
cbe	taken
cax	free
cak	free
caz	free
caq	free
cbb	free
cau	free
cay	free
cba	free
cbm	taken
cbc	free
cbf	free
cbi	free
cbj	free
cbp	taken
cbl	free
cbr	taken
cbs	taken
cbh	free
cbk	free
cbw	taken
cbg	free
cbo	free
cbx	taken
cca	taken
ccb	taken
ccc	taken
ccd	taken
cce	taken
cbn	free
cbt	free
ccg	taken
cbz	free
cbq	free
cck	taken
cbu	free
ccl	taken
ccm	taken
cbv	free
ccn	taken
ccp	taken
cby	free
ccs	taken
cci	free
ccv	taken
ccf	free
cch	free
ccj	free
ccy	taken
ccr	free
cct	free
cdb	taken
cdc	taken
ccu	free
cco	free
cdd	taken
ccq	free
cda	free
ccw	free
ccx	free
cdk	taken
cdg	free
cdm	taken
cdh	free
ccz	free
cdi	free
cdn	taken
cdj	free
cdo	taken
cdp	taken
cdr	taken
cds	taken
cdt	taken
cdf	free
cdu	taken
cde	free
cdx	taken
ceb	taken
cdq	free
cee	taken
cdl	free
cef	taken
cdw	free
cea	free
cec	free
ced	free
cel	taken
cem	taken
cdv	free
cdy	free
cdz	free
cen	taken
ceo	taken
cep	taken
ceq	taken
cer	taken
ces	taken
cek	free
cex	taken
ceg	free
ceh	free
cei	free
cej	free
cfb	taken
cet	free
ceu	free
cev	free
cew	free
cfg	taken
cfi	taken
cez	free
cfc	free
cfd	free
cey	free
cfa	free
cfk	taken
cfm	taken
cfn	taken
cfj	free
cfp	taken
cfe	free
cfs	taken
cff	free
cft	taken
cfh	free
cfx	taken
cfy	taken
cfo	free
cga	taken
cfq	free
cfv	free
cfl	free
cfw	free
cfr	free
cgi	taken
cfu	free
cgd	free
cge	free
cfz	free
cgl	taken
cgf	free
cgg	free
cgb	free
cgh	free
cgc	free
cgn	taken
cgo	taken
cgq	taken
cgs	taken
cgj	free
cgk	free
cgp	free
cgt	free
cgm	free
cgu	free
cgr	free
cha	taken
cgw	free
cgx	free
cgy	free
chd	taken
chg	taken
che	taken
chi	taken
cgv	free
chk	taken
chl	taken
cgz	free
cho	taken
chr	taken
chh	free
chs	taken
chb	free
cht	taken
chm	free
chc	free
chn	free
chp	free
chf	free
chq	free
chx	taken
cia	taken
chj	free
cid	taken
chv	free
chw	free
chy	free
chz	free
cik	taken
chu	free
cif	free
cin	taken
cib	free
cic	free
cih	free
cio	taken
cie	free
cip	taken
cig	free
cis	taken
ciu	taken
cil	free
cim	free
cij	free
cii	free
ciw	taken
cix	taken
ciq	free
cjb	taken
cir	free
cit	free
cjf	taken
ciy	free
ciz	free
cja	free
cjc	free
cjd	free
cjj	taken
cjk	taken
civ	free
cji	free
cje	free
cjg	free
cjm	free
cjs	taken
cjh	free
cjp	free
cjw	taken
cjl	free
cjn	free
cjy	taken
cjo	free
cjq	free
cjt	free
cju	free
cjr	free
cjv	free
ckd	taken
cjx	free
ckf	taken
ckk	taken
ckc	free
cke	free
cka	free
cjz	free
ckb	free
ckg	free
ckl	free
ckh	free
cki	free
ckj	free
cko	free
ckm	free
ckn	free
ckp	free
ckq	free
ckt	free
cku	free
cks	free
cla	taken
clc	taken
ckr	free
cld	taken
ckw	free
cle	taken
ckv	free
clf	taken
clg	taken
cli	taken
clj	taken
cll	taken
ckz	free
clm	taken
clo	taken
cln	taken
clp	taken
clq	taken
clr	taken
cls	taken
cky	free
clt	taken
ckx	free
clu	taken
clh	free
clx	taken
cly	taken
clb	free
cma	taken
cmb	taken
cmc	taken
cmd	taken
cme	taken
cmf	taken
cmi	taken
clk	free
cml	taken
clv	free
clz	free
cmp	taken
cmr	taken
cmh	free
clw	free
cmk	free
cms	taken
cmt	taken
cmn	free
cmx	taken
cmq	free
cmg	free
cmj	free
cmz	taken
cmm	free
cnc	taken
cmo	free
cnd	taken
cne	taken
cmv	free
cnf	taken
cmu	free
cnb	free
cnl	taken
cmw	free
cnn	taken
cmy	free
cnm	taken
cni	free
cna	free
cnp	taken
cnk	free
cns	taken
cnt	taken
cng	free
cnh	free
cnj	free
cno	free
coa	taken
cob	taken
coc	taken
cnu	free
cnv	free
cnw	free
cny	free
cod	taken
cnr	free
cnq	free
coe	taken
cof	taken
cog	taken
cnz	free
col	taken
com	taken
con	taken
coo	taken
cnx	free
cop	taken
cor	taken
cos	taken
cot	taken
cou	taken
cov	taken
coh	free
cow	taken
cox	taken
coy	taken
coz	taken
cpd	taken
cpf	taken
coq	free
coi	free
coj	free
cok	free
cpl	taken
cpa	free
cpb	free
cpc	free
cpm	taken
cpp	taken
cpg	free
cpi	free
cpr	taken
cpj	free
cps	taken
cpk	free
cpe	free
cpt	taken
cpu	taken
cpv	taken
cpx	taken
cpy	taken
cph	free
cpq	free
cpz	free
cpo	free
cpn	free
cqa	free
cqb	free
cqc	free
cqd	free
cqe	free
cql	taken
cpw	free
cqi	free
cqj	free
cqf	free
cqg	free
cqn	free
cqh	free
cqo	free
cqp	free
cqs	taken
cqk	free
cqw	taken
cqm	free
cqq	free
cqz	taken
cra	taken
cqr	free
crc	taken
crd	taken
cre	taken
cqx	free
crb	free
cqt	free
cqu	free
cqv	free
cqy	free
crm	taken
cri	free
cro	taken
crp	taken
crf	free
crg	free
crs	taken
crh	free
crk	free
crt	taken
crj	free
crx	taken
cry	taken
crz	taken
crq	free
csa	taken
crr	free
crl	free
crn	free
csc	taken
cse	taken
crv	free
csg	taken
csh	taken
csi	taken
csj	taken
csl	taken
csm	taken
csn	taken
cso	taken
crw	free
cru	free
csp	taken
csd	free
csr	taken
css	taken
cst	taken
csf	free
csv	taken
csw	taken
csb	free
csx	taken
csy	taken
cta	taken
ctc	taken
ctf	taken
ctg	taken
csu	free
csk	free
ctk	taken
ctl	taken
csq	free
ctm	taken
cth	free
cto	taken
cti	free
ctp	taken
csz	free
ctb	free
ctj	free
cte	free
ctd	free
ctr	taken
cts	taken
ctx	taken
ctn	free
cub	taken
ctu	free
ctt	free
ctw	free
cty	free
cua	free
cue	taken
ctq	free
cug	taken
cuc	free
cui	taken
cul	taken
ctv	free
cud	free
ctz	free
cup	taken
cuf	free
cur	taken
cus	taken
cut	taken
cum	free
cuq	free
cuh	free
cuj	free
cuk	free
cuy	taken
cuz	taken
cun	free
cuo	free
cux	free
cuv	free
cva	free
cuu	free
cuw	free
cvb	free
cve	free
cvc	free
cvd	free
cvm	taken
cvg	free
cvl	free
cvf	free
cvr	taken
cvo	free
cvh	free
cvk	free
cvi	free
cvq	free
cvj	free
cvn	free
cvp	free
cvt	free
cvw	free
cvx	free
cvy	free
cvz	free
cvs	free
cwd	taken
cwa	free
cvu	free
cwf	taken
cvv	free
cwb	free
cwl	taken
cwj	free
cwc	free
cwe	free
cwp	taken
cwg	free
cwm	free
cwo	free
cwi	free
cwh	free
cwt	taken
cwk	free
cwn	free
cwq	free
cwy	free
cwz	free
cwr	free
cww	free
cws	free
cwu	free
cxa	free
cwv	free
cwx	free
cxb	free
cxg	free
cxc	free
cxm	taken
cxn	taken
cxd	free
cxf	free
cxe	free
cxh	free
cxj	free
cxi	free
cxl	free
cxr	taken
cxs	taken
cxk	free
cxy	taken
cxx	taken
cya	taken
cxo	free
cxt	free
cyc	taken
cxw	free
cxq	free
cxv	free
cxp	free
cyb	free
cxu	free
cyk	taken
cxz	free
cyl	taken
cye	free
cyd	free
cyq	taken
cyf	free
cyj	free
cyh	free
cym	free
cyg	free
cyo	free
cyi	free
cyn	free
cyr	free
cyt	free
cyp	free
cyv	free
cyx	free
cyy	free
cys	free
cyu	free
cyw	free
cyz	free
czb	free
cza	free
czl	taken
cze	free
czc	free
czd	free
czj	free
czf	free
czg	free
czm	free
czh	free
czi	free
czk	free
czn	free
czp	free
czq	free
czz	taken
czo	free
czt	free
czu	free
daa	taken
czr	free
dab	taken
dac	taken
dad	taken
dae	taken
czy	free
dag	taken
czs	free
dai	taken
czv	free
dak	taken
czw	free
dal	taken
dam	taken
czx	free
dan	taken
dao	taken
daq	taken
dar	taken
dap	taken
das	taken
dat	taken
dav	taken
daf	free
dah	free
daw	taken
dax	taken
day	taken
dba	taken
dbb	taken
dbc	taken
dbf	taken
dbg	taken
dbi	taken
dau	free
dbl	taken
daj	free
dbm	taken
daz	free
dbn	taken
dbo	taken
dbe	free
dbq	taken
dbh	free
dbr	taken
dbs	taken
dbj	free
dbt	taken
dbk	free
dbx	taken
dbd	free
dca	taken
dbp	free
dcc	taken
dcd	taken
dcg	taken
dcb	free
dci	taken
dbu	free
dbv	free
dbw	free
dby	free
dck	taken
dbz	free
dcl	taken
dce	free
dcm	taken
dco	taken
dcp	taken
dcf	free
dcr	taken
dct	taken
dch	free
dcj	free
dcy	free
dcn	free
dcz	free
dcq	free
ddb	taken
dcu	free
dcs	free
ddc	taken
dcw	free
dcv	free
ddd	taken
ddg	taken
dcx	free
ddi	taken
ddk	taken
ddl	taken
ddm	taken
ddp	taken
dda	free
ddq	taken
dde	free
dds	taken
ddf	free
ddt	taken
ddj	free
ddv	taken
ddo	free
dea	taken
ddr	free
ddh	free
deb	taken
dec	taken
ddu	free
ded	taken
dee	taken
ddn	free
def	taken
ddx	free
deg	taken
ddy	free
dei	taken
del	taken
dem	taken
ddw	free
den	taken
deo	taken
dep	taken
ddz	free
deq	taken
der	taken
des	taken
dev	taken
dew	taken
dex	taken
deh	free
dfa	taken
dej	free
dek	free
dfd	taken
det	free
dey	free
dez	free
dfc	free
deu	free
dfe	free
dff	free
dfh	free
dfb	free
dfn	taken
dfp	taken
dfj	free
dfg	free
dfs	taken
dfl	free
dfi	free
dfk	free
dfy	taken
dfm	free
dft	free
dfo	free
dfu	free
dfw	free
dfq	free
dfr	free
dgg	taken
dfv	free
dfx	free
dga	free
dgb	free
dgc	free
dgd	free
dgm	taken
dfz	free
dgh	free
dgo	taken
dge	free
dgf	free
dgr	taken
dgl	free
dgs	taken
dgn	free
dgi	free
dgj	free
dgk	free
dgp	free
dgt	free
dgx	free
dgw	free
dgu	free
dgq	free
dgy	free
dgz	free
dhb	free
dgv	free
dha	free
dhf	free
dhl	taken
dhh	free
dhc	free
dhn	taken
dhj	free
dhk	free
dhe	free
dhg	free
dhs	taken
dhi	free
dht	taken
dhd	free
dhm	free
dhx	taken
dho	free
dhr	free
dia	taken
dib	taken
dic	taken
dhu	free
dhv	free
did	taken
die	taken
dhp	free
dif	taken
dig	taken
dhq	free
dhz	free
dik	taken
dil	taken
dim	taken
din	taken
dio	taken
dhw	free
dip	taken
diq	taken
dhy	free
dir	taken
dih	free
dis	taken
dit	taken
dii	free
diu	taken
dij	free
div	taken
diy	taken
diz	taken
dja	taken
djb	taken
dji	taken
diw	free
djd	free
djj	free
dix	free
dje	free
djf	free
djc	free
djh	free
djg	free
djl	free
djs	taken
djk	free
djm	free
djv	taken
djn	free
djx	taken
djq	free
djt	free
djo	free
djw	free
djp	free
djr	free
dju	free
dka	free
djy	free
djz	free
dke	free
dkk	taken
dkb	free
dkg	free
dkf	free
dkc	free
dkh	free
dkd	free
dkr	taken
dki	free
dkl	free
dkn	free
dkm	free
dko	free
dkj	free
dkt	free
dkp	free
dkq	free
dlb	taken
dkv	free
dks	free
dkx	free
dkw	free
dlc	taken
dld	taken
dkz	free
dli	taken
dku	free
dll	taken
dky	free
dln	taken
dle	free
dlg	free
dla	free
dlj	free
dlk	free
dlm	free
dls	taken
dlh	free
dlf	free
dlv	taken
dlx	taken
dlr	free
dma	taken
dlt	free
dlo	free
dlu	free
dmc	taken
dmd	taken
dlq	free
dme	taken
dlp	free
dly	free
dlz	free
dmh	taken
dmi	taken
dmg	taken
dml	taken
dmn	taken
dmb	free
dlw	free
dmp	taken
dmm	taken
dms	taken
dmt	taken
dmf	free
dmu	taken
dmv	taken
dmk	free
dmx	taken
dmy	taken
dna	taken
dnc	taken
dnd	taken
dmq	free
dmr	free
dmj	free
dni	taken
dmw	free
dmz	free
dmo	free
dnk	taken
dnb	free
dnn	taken
dno	taken
dnf	free
dng	free
dnr	taken
dns	taken
dnj	free
dnt	taken
dne	free
dnh	free
dnq	free
dnl	free
dnm	free
doa	taken
dnv	free
dob	taken
dnw	free
dnx	free
dnp	free
doc	taken
dod	taken
doe	taken
dof	taken
doh	taken
doi	taken
doj	taken
dog	taken
dnu	free
dok	taken
dom	taken
don	taken
doo	taken
dny	free
dop	taken
dor	taken
dos	taken
dnz	free
doq	taken
dou	taken
dot	taken
dow	taken
dox	taken
doy	taken
dpd	taken
dpe	taken
dov	free
dol	free
doz	free
dpa	free
dpc	free
dpf	free
dpl	taken
dpm	taken
dpn	taken
dpo	taken
dpb	free
dpp	taken
dpr	taken
dpg	free
dpj	free
dps	taken
dpk	free
dpt	taken
dph	free
dpv	taken
dpi	free
dqb	taken
dpq	free
dpx	free
dpy	free
dpz	free
dqd	free
dqc	free
dqh	taken
dpu	free
dpw	free
dql	taken
dqa	free
dqn	taken
dqe	free
dqg	free
dqf	free
dqt	taken
dqo	free
dqi	free
dqj	free
dqk	free
dqm	free
dqr	free
dqs	free
dqp	free
dqq	free
dqu	free
drc	taken
dqv	free
dqw	free
dre	taken
dqz	free
dri	taken
drk	taken
drd	free
dqy	free
dqx	free
drg	free
drm	taken
drb	free
dra	free
drp	taken
drs	taken
drf	free
drh	free
drl	free
drn	free
dro	free
drr	free
dry	taken
drj	free
drt	free
dsa	taken
dsb	taken
dsd	taken
dsf	taken
drq	free
dsg	taken
dru	free
dsh	taken
dsj	taken
drv	free
dsk	taken
drw	free
drx	free
dsl	taken
dse	free
dsm	taken
dsn	taken
drz	free
dsp	taken
dsq	taken
dss	taken
dst	taken
dsv	taken
dsc	free
dsw	taken
dsx	taken
dta	taken
dtd	taken
dtc	taken
dso	free
dsi	free
dsr	free
dtf	taken
dtg	taken
dti	taken
dtl	taken
dtb	free
dtm	taken
dte	free
dto	taken
dsu	free
dsz	free
dtp	taken
dsy	free
dtr	taken
dtk	free
dts	taken
dtv	taken
dtw	taken
dtx	taken
dth	free
dub	taken
dtj	free
dtq	free
dtt	free
due	taken
dtu	free
dtn	free
duh	taken
dui	taken
dua	free
duc	free
dud	free
dun	taken
dty	free
dtz	free
duf	free
duo	taken
dug	free
dup	taken
duj	free
dur	taken
duk	free
dux	taken
dum	free
duz	taken
dva	taken
dvc	taken
dul	free
dut	free
duv	free
duw	free
duy	free
dus	free
duu	free
duq	free
dvd	taken
dvb	free
dve	taken
dvl	taken
dvm	taken
dvn	taken
dvj	free
dvg	free
dvf	free
dvh	free
dvs	taken
dvp	free
dvi	free
dvx	taken
dvk	free
dvo	free
dvq	free
dwb	taken
dvr	free
dvw	free
dvt	free
dvu	free
dvv	free
dwd	free
dvy	free
dwc	free
dwa	free
dvz	free
dwj	taken
dwf	free
dwn	taken
dwg	free
dwe	free
dwi	free
dwr	taken
dws	taken
dwt	taken
dwl	free
dwv	taken
dwm	free
dwo	free
dwh	free
dwz	taken
dwq	free
dxa	taken
dwk	free
dwp	free
dxf	taken
dww	free
dwx	free
dxj	taken
dwu	free
dwy	free
dxi	free
dxg	free
dxh	free
dxb	free
dxc	free
dxd	free
dxe	free
dxp	taken
dxt	taken
dxl	free
dxw	taken
dxm	free
dxk	free
dxr	free
dxn	free
dxo	free
dxq	free
dxs	free
dxx	free
dxy	free
dxu	free
dxz	free
dyd	taken
dye	taken
dxv	free
dyc	free
dya	free
dyf	free
dyn	taken
dyb	free
dyg	free
dyj	free
dyh	free
dyi	free
dyk	free
dyl	free
dys	taken
dyo	free
dyq	free
dym	free
dyp	free
dyt	free
dyw	free
dyx	free
dyr	free
dyu	free
dyv	free
dyy	free
dzb	free
dzd	free
dzi	taken
dza	free
dze	free
dyz	free
dzk	taken
dzf	free
dzc	free
dzl	free
dzh	free
dzg	free
dzo	free
dzq	free
dzj	free
dzm	free
dzn	free
dzp	free
dzt	free
dzr	free
eac	taken
dzw	free
dzs	free
dzu	free
eaa	free
dzv	free
dzx	free
dzy	free
ead	free
dzz	free
eae	free
eab	free
eam	taken
ean	taken
eah	free
eai	free
eap	taken
ear	taken
eaf	free
eat	taken
eak	free
eal	free
eag	free
eaw	taken
eaj	free
ebb	taken
eau	free
eav	free
eao	free
eaq	free
eax	free
eay	free
eba	free
eas	free
ebc	free
eaz	free
ebf	free
ebg	free
ebh	free
ebi	free
ebd	free
ebe	free
ebl	free
ebs	taken
ebj	free
ebk	free
ebn	free
ebo	free
ebq	free
ebm	free
ebr	free
eca	taken
ebt	free
ecb	taken
ebp	free
ebv	free
ecc	taken
ebx	free
ecg	taken
ebz	free
ech	taken
ebu	free
ebw	free
ecl	taken
ecm	taken
eby	free
eco	taken
ecp	taken
eci	free
ecj	free
ecs	taken
ect	taken
eck	free
ecd	free
ecv	taken
ece	free
ecx	taken
ecf	free
ecq	free
eda	taken
edb	taken
edf	taken
ecn	free
ecu	free
ecw	free
edg	taken
ecr	free
edi	taken
ecz	free
edj	taken
edc	free
edk	taken
edd	free
edn	taken
edm	taken
edo	taken
ecy	free
edp	taken
edr	taken
edu	taken
edx	taken
edy	taken
edl	free
ede	free
edh	free
edq	free
edt	free
edv	free
eee	taken
eeg	taken
edz	free
eds	free
edw	free
eek	taken
eel	taken
eem	taken
eeh	free
eea	free
een	taken
eeb	free
eec	free
eei	free
eed	free
eep	taken
eej	free
ees	taken
eet	taken
eev	taken
eef	free
eeq	free
eeu	free
eex	free
efc	taken
efd	taken
eez	free
eeo	free
efb	free
eer	free
efe	taken
eff	taken
eew	free
eey	free
efa	free
efo	taken
efl	free
efm	free
efn	free
efs	taken
efh	free
efg	free
efi	free
eft	taken
efj	free
efk	free
efq	free
efw	taken
efp	free
efu	free
efv	free
efx	free
ega	free
efr	free
egg	taken
egd	free
efz	free
efy	free
egb	free
egc	free
egf	free
ego	taken
egh	free
egi	free
ege	free
egs	taken
egk	free
egl	free
egn	free
egp	free
egj	free
egq	free
egt	free
egu	free
egm	free
egv	free
egr	free
ehd	taken
egx	free
egy	free
egw	free
eha	free
ehb	free
ehc	free
egz	free
ehe	free
ehf	free
ehg	free
ehh	free
eho	taken
ehi	free
ehp	taken
ehk	free
ehu	taken
ehl	free
ehq	free
ehj	free
ehr	free
eht	free
ehs	free
ehm	free
ehn	free
ehw	free
ehv	free
ehy	free
eia	free
ehx	free
eib	free
eic	free
eig	taken
eii	taken
eim	taken
ein	taken
ehz	free
eid	free
eio	taken
eip	taken
eif	free
eie	free
eih	free
eik	free
eit	taken
eij	free
eir	free
eis	free
eil	free
eiu	free
eiw	free
eix	free
eiy	free
eiq	free
eiv	free
eiz	free
eji	taken
ejd	free
eje	free
eja	free
ejg	free
ejb	free
ejc	free
ejk	free
ejh	free
ejf	free
ejm	free
ejr	taken
ejs	taken
ejt	taken
ejn	free
ejj	free
ejo	free
ejq	free
ejl	free
ejp	free
ejv	free
eka	free
eke	taken
ekc	free
ekg	taken
eju	free
ejw	free
ejx	free
ejy	free
ejz	free
ekk	taken
ekb	free
ekm	taken
ekn	taken
eko	taken
ekf	free
ekd	free
ekj	free
ekl	free
ekp	free
eki	free
ekh	free
ekr	free
ekt	free
eks	free
ela	taken
elc	taken
ekq	free
ele	taken
eku	free
elf	taken
elg	taken
ekz	free
eli	taken
ekv	free
ekw	free
elk	taken
eld	free
ell	taken
elm	taken
ekx	free
eky	free
elo	taken
elp	taken
elq	taken
elb	free
elh	free
elr	taken
elu	taken
elv	taken
elj	free
elx	taken
ema	taken
emc	taken
emd	taken
eme	taken
emf	taken
els	free
eln	free
emi	taken
elz	free
emb	free
eml	taken
elt	free
emm	taken
elw	free
emo	taken
ely	free
emp	taken
emh	free
emj	free
ems	taken
emt	taken
emu	taken
emv	taken
emw	taken
emy	taken
emn	free
emg	free
ena	taken
enb	taken
enc	taken
end	taken
emk	free
ene	taken
enf	taken
eng	taken
emx	free
emq	free
emr	free
eno	taken
emz	free
enq	taken
enk	free
enl	free
ens	taken
ent	taken
enu	taken
env	taken
enj	free
enh	free
eni	free
enm	free
enx	taken
enn	free
eoc	taken
enp	free
eof	taken
eob	taken
enw	free
enr	free
eoa	free
eny	free
eol	taken
enz	free
eog	free
eoh	free
eoj	free
eoi	free
eon	taken
eod	free
eoo	taken
eoe	free
eos	taken
eox	taken
eom	free
eok	free
eop	free
eor	free
eov	free
epa	taken
eoq	free
eou	free
eot	free
eoz	free
eow	free
epf	taken
epb	free
epg	taken
epi	taken
epj	taken
epc	free
epd	free
eoy	free
epl	taken
epm	taken
epo	taken
epp	taken
eps	taken
epr	taken
ept	taken
epe	free
epn	free
eph	free
epk	free
epv	free
epw	free
eqe	taken
epq	free
epu	free
epx	free
epy	free
epz	free
eqb	free
eqd	free
eqa	free
eql	taken
eqc	free
eqh	free
eqo	taken
eqq	taken
eqf	free
eqg	free
eqk	free
equ	taken
eqi	free
eqn	free
eqj	free
eqm	free
eqs	free
era	taken
erb	taken
eqv	free
eqr	free
eqp	free
erc	taken
eqy	free
eqw	free
ere	taken
eqz	free
erf	taken
eqt	free
erg	taken
erk	taken
erm	taken
ero	taken
eqx	free
erp	taken
err	taken
erd	free
ert	taken
ern	free
erq	free
erx	taken
eri	free
erh	free
erj	free
eru	free
erl	free
erv	free
esa	taken
esb	taken
esc	taken
esd	taken
ese	taken
esf	taken
ers	free
esg	taken
esh	taken
esi	taken
esl	taken
ery	free
esm	taken
erw	free
eso	taken
esq	taken
esp	taken
erz	free
ess	taken
est	taken
esu	taken
esx	taken
esy	taken
esj	free
esk	free
eta	taken
etc	taken
esr	free
eth	taken
esw	free
esv	free
esz	free
esn	free
eti	taken
etd	free
etk	taken
ete	free
etl	taken
etm	taken
etg	free
etp	taken
ets	taken
etb	free
etf	free
etw	taken
etj	free
eto	free
etq	free
etn	free
etr	free
ett	free
eue	taken
etu	free
etv	free
eua	free
euc	free
eui	taken
etx	free
ety	free
etz	free
eub	free
eun	taken
eud	free
eug	free
euj	free
euf	free
euh	free
eup	free
euk	free
eul	free
eum	free
euo	free
eut	free
euq	free
eva	taken
eur	free
euu	free
eus	free
eve	taken
eux	free
euv	free
evd	free
evc	free
euy	free
euw	free
evi	taken
evf	free
evl	taken
evm	taken
evn	taken
euz	free
evb	free
evo	taken
evh	free
evp	taken
evr	taken
evs	taken
evt	taken
evx	taken
evg	free
evy	taken
evk	free
evj	free
evw	free
ewe	taken
evq	free
ewd	free
evv	free
evu	free
evz	free
ewa	free
ewb	free
ewc	free
ewf	free
ewg	free
ewi	free
ewk	free
ewj	free
ews	taken
ewm	free
ewn	free
ewh	free
ewo	free
ewp	free
eww	taken
ewq	free
ewl	free
ewr	free
exa	taken
exc	taken
exe	taken
ewu	free
exf	taken
ewy	free
ewt	free
exb	free
ewv	free
ewx	free
ewz	free
exm	taken
exn	taken
exo	taken
exd	free
exp	taken
exj	free
exr	taken
exs	taken
ext	taken
exl	free
exg	free
exh	free
exx	taken
exi	free
exy	taken
exk	free
eye	taken
exv	free
exq	free
exw	free
eya	free
eyc	free
exu	free
eyh	free
exz	free
eyf	free
eyb	free
eyd	free
eyo	taken
eyg	free
eyn	free
eyi	free
eyj	free
eyk	free
eyq	free
eyl	free
eym	free
eyp	free
eys	free
eyr	free
eyt	free
eyv	free
eyw	free
ezd	taken
eze	taken
eyz	free
eyu	free
eza	free
ezb	free
eyy	free
eyx	free
ezl	taken
ezg	free
ezc	free
ezj	free
ezf	free
ezm	free
ezh	free
ezo	free
ezi	free
ezs	taken
ezv	taken
ezp	free
ezk	free
ezn	free
ezy	taken
fab	taken
fac	taken
ezu	free
ezt	free
fad	taken
fae	taken
ezw	free
ezx	free
ezr	free
ezq	free
faf	taken
fag	taken
faa	free
fai	taken
fam	taken
fan	taken
faq	taken
far	taken
fas	taken
ezz	free
fat	taken
fav	taken
fah	free
faj	free
fak	free
fal	free
fao	free
fax	taken
fay	taken
fap	free
fba	taken
fbg	taken
fau	free
faw	free
fbi	taken
faz	free
fbc	free
fbf	free
fbh	free
fbb	free
fbd	free
fbp	taken
fbk	free
fbe	free
fbl	free
fbr	taken
fbs	taken
fbm	free
fbn	free
fbj	free
fbo	free
fbw	taken
fbx	taken
fcc	taken
fbq	free
fbu	free
fbv	free
fbz	free
fcb	free
fbt	free
fby	free
fca	free
fch	free
fcm	taken
fcd	free
fce	free
fcp	taken
fcf	free
fcj	free
fcg	free
fcs	taken
fcl	free
fci	free
fco	free
fck	free
fcq	free
fcr	free
fct	free
fcu	free
fcn	free
fdb	taken
fcv	free
fdc	taken
fdd	taken
fde	taken
fdf	taken
fdg	taken
fdi	taken
fcz	free
fcy	free
fdk	taken
fdl	taken
fdm	taken
fcw	free
fcx	free
fdr	taken
fds	taken
fdt	taken
fda	free
fdj	free
fdu	taken
fdx	taken
fdo	free
fdy	taken
fdn	free
fdq	free
fdh	free
fea	taken
feb	taken
fec	taken
fed	taken
fef	taken
fdv	free
fdp	free
fee	taken
feg	taken
fei	taken
fel	taken
fem	taken
fen	taken
feo	taken
fep	taken
feq	taken
fer	taken
fdw	free
fes	taken
fet	taken
fdz	free
few	taken
feh	free
fey	taken
fex	taken
fez	taken
fek	free
fej	free
ffa	taken
ffe	taken
fff	taken
ffi	taken
fev	free
ffm	taken
feu	free
ffg	free
ffh	free
ffj	free
ffb	free
ffd	free
ffc	free
ffs	taken
fft	taken
ffu	taken
ffn	free
ffk	free
ffl	free
ffo	free
ffp	free
ffr	free
ffv	free
ffx	free
ffq	free
ffw	free
ffy	free
fgc	free
fgg	taken
fgh	taken
ffz	free
fgb	free
fga	free
fgd	free
fgi	free
fgl	free
fge	free
fgf	free
fgo	free
fgk	free
fgj	free
fgp	free
fgm	free
fgn	free
fgr	free
fgq	free
fgs	free
fgx	free
fgt	free
fhc	taken
fgv	free
fgu	free
fgw	free
fhe	taken
fgy	free
fhb	free
fha	free
fgz	free
fhd	free
fhf	free
fhh	free
fhj	free
fhm	free
fhl	free
fhi	free
fhq	taken
fho	free
fhg	free
fhk	free
fhp	free
fhn	free
fht	free
fia	taken
fhv	free
fib	taken
fhx	free
fhy	free
fic	taken
fid	taken
fie	taken
fhz	free
fhr	free
fif	taken
fig	taken
fhs	free
fil	taken
fhu	free
fhw	free
fim	taken
fin	taken
fio	taken
fip	taken
fir	taken
fih	free
fis	taken
fii	free
fik	free
fit	taken
fix	taken
fiz	taken
fiq	free
fij	free
fiv	free
fiw	free
fja	free
fjb	free
fiu	free
fiy	free
fjd	free
fjc	free
fjl	taken
fjh	free
fje	free
fjf	free
fjg	free
fji	free
fjj	free
fjn	free
fjs	taken
fjk	free
fjv	taken
fjr	free
fjm	free
fjw	free
fjo	free
fjq	free
fjp	free
fjz	free
fju	free
fjt	free
fjy	free
fjx	free
fkb	free
fka	free
fkd	free
fkf	free
fkg	free
fkc	free
fke	free
fki	free
fkh	free
fkm	free
fkj	free
fkt	taken
fkl	free
fkk	free
fkr	free
fko	free
fkn	free
fkp	free
fkq	free
fku	free
fkv	free
flc	taken
fkx	free
fks	free
fky	free
flg	taken
fli	taken
flj	taken
fkw	free
fla	free
fle	free
flf	free
flo	taken
fkz	free
flb	free
fld	free
flp	taken
flk	free
fls	taken
flu	taken
flh	free
fln	free
flv	taken
flx	taken
flw	taken
fly	taken
fll	free
fmc	taken
flm	free
fmd	taken
flr	free
fmg	taken
flq	free
fma	free
fmb	free
flt	free
fml	taken
fme	free
fmh	free
fmi	free
flz	free
fmp	taken
fmr	taken
fms	taken
fmk	free
fmt	taken
fmf	free
fmj	free
fmo	free
fmq	free
fnb	taken
fmm	free
fmn	free
fmv	free
fmx	free
fmw	free
fnc	taken
fnd	taken
fnf	taken
fnk	taken
fmu	free
fmy	free
fne	free
fmz	free
fni	free
fna	free
fnp	taken
fnq	taken
fnl	free
fng	free
fns	taken
fnh	free
fnj	free
fnu	taken
fnv	taken
fnx	taken
fno	free
foa	taken
fnm	free
foc	taken
fnn	free
foe	taken
fnt	free
fof	taken
fog	taken
fny	free
foj	taken
fnr	free
fok	taken
fob	free
fol	taken
fom	taken
foo	taken
fod	free
fnw	free
fop	taken
for	taken
fnz	free
fou	taken
fow	taken
fox	taken
fon	free
foh	free
foi	free
fos	free
fot	free
foq	free
fpa	free
fov	free
fpb	free
foy	free
foz	free
fpe	free
fpf	free
fpl	taken
fpm	taken
fpc	free
fpn	taken
fpd	free
fph	free
fpo	taken
fpp	taken
fps	taken
fpk	free
fpg	free
fpx	taken
fpj	free
fpi	free
fqb	taken
fpv	free
fpq	free
fpr	free
fpy	free
fpt	free
fpz	free
fpu	free
fpw	free
fqa	free
fql	taken
fqg	free
fqc	free
fqd	free
fqe	free
fqf	free
fqh	free
fqi	free
fqj	free
fqk	free
fqs	taken
fqr	free
fqt	free
fqv	free
fqm	free
fqn	free
fqp	free
fqo	free
fqq	free
fqw	free
frb	taken
frc	taken
fqu	free
fri	taken
fqz	free
fqy	free
fra	free
fre	free
frf	free
fqx	free
frl	taken
frg	free
frh	free
frm	taken
fro	taken
frp	taken
frd	free
frj	free
frk	free
fry	taken
frt	free
fru	free
fsa	taken
frn	free
fsb	taken
frq	free
fsc	taken
frr	free
frs	free
fse	taken
frv	free
fsg	taken
fsh	taken
frw	free
fsi	taken
fsj	taken
fsk	taken
frx	free
fsm	taken
fso	taken
fsn	taken
fsd	free
fsp	taken
fsq	taken
fsf	free
frz	free
fss	taken
fsu	taken
fsv	taken
fsx	taken
ftb	taken
ftc	taken
ftf	taken
fsl	free
fsw	free
fsz	free
fta	free
fsr	free
ftd	free
fst	free
ftl	taken
fsy	free
ftp	taken
fte	free
ftj	free
ftk	free
ftg	free
ftm	free
ftt	taken
fth	free
fts	taken
fto	free
ftw	taken
fti	free
ftx	taken
fua	taken
ftq	free
ftn	free
fuc	taken
fug	taken
ftu	free
ftv	free
ftr	free
fui	taken
ful	taken
fud	free
fuf	free
ftz	free
fty	free
fun	taken
fub	free
fup	taken
fuj	free
fur	taken
fue	free
fus	taken
fut	taken
fuu	taken
fum	free
fux	taken
fuh	free
fuz	taken
fuk	free
fvd	taken
fuw	free
fuo	free
fuq	free
fvg	taken
fvc	free
fvb	free
fve	free
fuv	free
fuy	free
fvf	free
fvm	taken
fva	free
fvh	free
fvk	free
fvl	free
fvn	free
fvj	free
fvq	free
fvr	free
fvi	free
fvs	free
fvp	free
fvo	free
fvt	free
fvu	free
fvv	free
fwd	taken
fvw	free
fvx	free
fwa	free
fwc	free
fwb	free
fvy	free
fvz	free
fwe	free
fwk	taken
fwh	free
fwf	free
fwg	free
fwl	free
fwi	free
fwn	free
fwm	free
fwr	taken
fwo	free
fws	taken
fwp	free
fwj	free
fwq	free
fww	free
fwy	free
fwx	free
fxb	free
fwt	free
fwv	free
fwu	free
fxa	free
fwz	free
fxd	taken
fxc	free
fxg	free
fxk	free
fxl	free
fxm	free
fxf	free
fxi	free
fxh	free
fxj	free
fxe	free
fxn	taken
fxs	taken
fxt	taken
fxq	taken
fxy	taken
fxp	free
fxu	free
fxw	free
fxr	free
fxx	free
fxz	free
fya	free
fyd	taken
fyg	taken
fyb	free
fxo	free
fyh	taken
fyi	taken
fxv	free
fyj	taken
fyp	taken
fyc	free
fyf	free
fyl	free
fyn	free
fyq	free
fye	free
fyr	free
fyk	free
fym	free
fyo	free
fyz	taken
fys	free
fyw	free
fyt	free
fzf	taken
fyu	free
fyv	free
fyx	free
fyy	free
fza	free
fze	free
fzb	free
fzc	free
fzd	free
fzg	free
fzh	free
fzl	free
fzn	free
fzi	free
fzp	free
fzj	free
fzk	free
fzm	free
fzo	free
fzy	taken
fzr	free
fzs	free
fzu	free
fzt	free
gab	taken
gac	taken
gad	taken
fzq	free
gae	taken
gaf	taken
fzx	free
fzw	free
gag	taken
gai	taken
fzz	free
gak	taken
gal	taken
gan	taken
gao	taken
fzv	free
gap	taken
gas	taken
gat	taken
gau	taken
gah	free
gaa	free
gax	taken
gam	free
gay	taken
gaz	taken
gba	taken
gbe	taken
gaj	free
gav	free
gaw	free
gaq	free
gar	free
gbb	free
gbk	taken
gbm	taken
gbd	free
gbj	free
gbf	free
gbc	free
gbl	free
gbp	taken
gbg	free
gbr	taken
gbs	taken
gbh	free
gbi	free
gbw	taken
gbo	free
gbn	free
gbq	free
gbu	free
gcc	taken
gcd	taken
gbz	free
gcf	taken
gch	taken
gbt	free
gbv	free
gbx	free
gcl	taken
gce	free
gcm	taken
gcn	taken
gby	free
gcb	free
gca	free
gco	taken
gcr	taken
gcs	taken
gcj	free
gck	free
gcw	taken
gcg	free
gci	free
gda	taken
gdb	taken
gct	free
gcv	free
gcq	free
gcy	free
gcp	free
gcz	free
gdg	taken
gcu	free
gdk	taken
gcx	free
gdd	free
gde	free
gdm	taken
gdf	free
gdo	taken
gdp	taken
gdc	free
gdh	free
gds	taken
gdj	free
gdt	taken
gdx	taken
gdn	free
gdi	free
gdl	free
geb	taken
gdr	free
gdv	free
gdu	free
ged	taken
gdy	free
gee	taken
gdz	free
gdq	free
gea	free
gel	taken
gdw	free
gem	taken
gec	free
gen	taken
geo	taken
gef	free
geg	free
gep	taken
ger	taken
gej	free
get	taken
gex	taken
geh	free
gez	taken
gei	free
gek	free
ges	free
geu	free
gev	free
gfc	taken
gew	free
gfe	taken
gff	taken
geq	free
gfl	taken
gey	free
gfm	taken
gfi	free
gfa	free
gfb	free
gfd	free
gfg	free
gfh	free
gfj	free
gfs	taken
gfn	free
gfk	free
gfw	taken
gfx	taken
gfq	free
gfo	free
gfp	free
gfv	free
gfu	free
gfr	free
ggd	taken
gfz	free
gga	free
gft	free
ggg	taken
gfy	free
ggl	taken
ggb	free
ggc	free
ggj	free
ggi	free
ggo	taken
ggf	free
gge	free
ggs	taken
ggm	free
ggh	free
ggk	free
ggp	free
ggq	free
ggn	free
ggr	free
ggu	free
ghb	taken
ghc	taken
ggw	free
ggx	free
ggy	free
ggt	free
ggz	free
ggv	free
ghi	taken
gha	free
ghk	taken
ghm	taken
ghn	taken
ghg	free
gho	taken
ghp	taken
ghd	free
ght	taken
ghe	free
ghl	free
ghf	free
ghu	taken
ghh	free
ghw	taken
ghx	taken
ghy	taken
ghj	free
ghq	free
ghr	free
gia	taken
gib	taken
ghs	free
gic	taken
gif	taken
gid	taken
gig	taken
gik	taken
gil	taken
gin	taken
gim	taken
gip	taken
gir	taken
ghv	free
gie	free
gis	taken
gij	free
gih	free
git	taken
ghz	free
giu	taken
gix	taken
giz	taken
giq	free
gii	free
gio	free
giv	free
giw	free
gja	free
gjh	taken
gjc	free
gjd	free
gjk	taken
gjf	free
gjb	free
giy	free
gjg	free
gje	free
gjl	free
gjs	taken
gjm	free
gji	free
gjo	free
gjv	taken
gjj	free
gjp	free
gka	taken
gjn	free
gjq	free
gjr	free
gjx	free
gjw	free
gjt	free
gju	free
gkb	free
gkc	free
gjy	free
gjz	free
gke	free
gkm	taken
gkh	free
gko	taken
gki	free
gkd	free
gkj	free
gkk	free
gkg	free
gkf	free
gks	taken
gkt	taken
gkn	free
gkl	free
gkq	free
glb	taken
gkv	free
gkw	free
gkx	free
gkp	free
gkr	free
glc	taken
gkz	free
gku	free
gli	taken
gky	free
gla	free
gle	free
gld	free
gll	taken
glk	free
glm	taken
glf	free
glo	taken
glg	free
glp	taken
glh	free
glr	taken
glj	free
gls	taken
glu	taken
gma	taken
gmb	taken
gln	free
gmd	taken
gme	taken
glv	free
glw	free
glq	free
glt	free
glx	free
gly	free
glz	free
gml	taken
gmf	free
gmc	free
gmh	free
gmi	free
gmo	taken
gms	taken
gmt	taken
gmg	free
gmk	free
gmn	free
gmj	free
gmp	free
gmr	free
gna	taken
gnb	taken
gmu	free
gmm	free
gmw	free
gmx	free
gmq	free
gnd	taken
gne	taken
gmy	free
gng	taken
gmv	free
gnl	taken
gnm	taken
gnc	free
gmz	free
gni	free
gnj	free
gnk	free
gnt	taken
gnf	free
gnu	taken
gnp	free
gnh	free
gno	free
gnz	taken
goa	taken
gnn	free
gns	free
gob	taken
god	taken
gnq	free
gnv	free
gnr	free
gog	taken
gnx	free
gol	taken
gom	taken
gnw	free
gny	free
gon	taken
goo	taken
gop	taken
goj	free
goc	free
gof	free
gor	taken
got	taken
goe	free
gou	taken
goh	free
gov	taken
goi	free
goy	taken
goz	taken
gok	free
gpb	taken
goq	free
gpg	taken
gos	free
gow	free
gox	free
gpj	taken
gpa	free
gpl	taken
gpm	taken
gpe	free
gpp	taken
gpc	free
gpr	taken
gph	free
gpi	free
gpd	free
gpf	free
gps	taken
gpt	taken
gpu	taken
gpq	free
gpk	free
gqb	taken
gpn	free
gpo	free
gpw	free
gpy	free
gpz	free
gpv	free
gpx	free
gqe	free
gqa	free
gqg	free
gql	taken
gqc	free
gqd	free
gqi	free
gqf	free
gqj	free
gqh	free
gqo	free
gqq	free
gqk	free
gqm	free
gqs	free
gqt	free
gqn	free
gqp	free
gra	taken
gqr	free
grc	taken
grd	taken
gre	taken
gqu	free
gqx	free
grh	taken
gqv	free
grb	free
grm	taken
gqw	free
gqz	free
gqy	free
grg	free
gro	taken
grp	taken
grr	taken
grs	taken
grk	free
grf	free
gru	taken
grl	free
grw	taken
grx	taken
gry	taken
gri	free
grj	free
grz	taken
gsa	taken
grq	free
gsb	taken
gsc	taken
gsd	taken
gsh	taken
grv	free
grn	free
gsl	taken
gsm	taken
gso	taken
grt	free
gsf	free
gsp	taken
gse	free
gsq	taken
gsr	taken
gsk	free
gss	taken
gst	taken
gsx	taken
gsg	free
gsi	free
gsj	free
gtb	taken
gtc	taken
gtd	taken
gsn	free
gsw	free
gsy	free
gsz	free
gta	free
gsu	free
gsv	free
gti	taken
gtk	taken
gtl	taken
gte	free
gtm	taken
gtf	free
gtp	taken
gtr	taken
gtt	taken
gtg	free
gtn	free
gtx	taken
gts	free
gtu	free
gtj	free
gth	free
gua	taken
gto	free
gue	taken
gtq	free
guf	taken
gtv	free
gug	taken
gty	free
gtw	free
guh	taken
gui	taken
gul	taken
gum	taken
gub	free
gun	taken
guo	taken
gud	free
gup	taken
gus	taken
gtz	free
gut	taken
guv	taken
guc	free
guj	free
guy	taken
guk	free
gvc	taken
gux	free
guq	free
gur	free
guu	free
guw	free
guz	free
gva	free
gvb	free
gvd	free
gve	free
gvn	taken
gvi	free
gvf	free
gvh	free
gvg	free
gvl	free
gvj	free
gvk	free
gvp	free
gvm	free
gvo	free
gvt	free
gvu	free
gvq	free
gvz	taken
gvr	free
gvv	free
gvs	free
gvw	free
gvy	free
gvx	free
gwc	free
gwd	free
gwe	free
gwh	taken
gwb	free
gwa	free
gwf	free
gwk	free
gwj	free
gwl	free
gwg	free
gwn	free
gwt	taken
gwo	free
gwp	free
gwi	free
gwq	free
gwm	free
gwz	taken
gwr	free
gws	free
gwu	free
gwv	free
gww	free
gwx	free
gxg	taken
gxa	free
gwy	free
gxe	free
gxb	free
gxh	free
gxm	taken
gxc	free
gxi	free
gxj	free
gxd	free
gxk	free
gxf	free
gxl	free
gxn	free
gxs	free
gxr	free
gxt	free
gxu	free
gxv	free
gxo	free
gxp	free
gxq	free
gxw	free
gxy	free
gya	free
gyb	free
gxx	free
gxz	free
gyf	free
gyg	free
gyc	free
gym	taken
gyd	free
gye	free
gyp	taken
gyj	free
gyr	taken
gys	taken
gyt	taken
gyl	free
gyh	free
gyi	free
gyn	free
gyo	free
gyy	taken
gyk	free
gyq	free
gza	free
gyu	free
gyx	free
gyw	free
gyv	free
gyz	free
gzb	free
gzc	free
gzd	free
gze	free
gzg	free
gzh	free
gzf	free
gzl	free
gzi	free
gzj	free
gzk	free
gzm	free
gzo	free
gzn	free
gzp	free
gzq	free
gzs	free
gzt	free
gzu	free
gzv	free
gzr	free
hac	taken
gzw	free
had	taken
gzy	free
gzz	free
haa	free
hah	taken
hai	taken
hak	taken
hal	taken
han	taken
ham	taken
gzx	free
hap	taken
hao	taken
hae	free
har	taken
has	taken
hab	free
hat	taken
hag	free
hau	taken
haj	free
haw	taken
hax	taken
hay	taken
haz	taken
haf	free
hbg	taken
hbi	taken
hba	free
haq	free
hbb	free
hbe	free
hav	free
hbo	taken
hbd	free
hbc	free
hbj	free
hbf	free
hbp	taken
hbh	free
hbk	free
hbs	taken
hbm	free
hbn	free
hbl	free
hbw	free
hbv	free
hbu	free
hbq	free
hbr	free
hbt	free
hcc	taken
hcd	taken
hcf	taken
hci	taken
hcj	taken
hbx	free
hcl	taken
hce	free
hby	free
hca	free
hbz	free
hcb	free
hck	free
hcp	taken
hcm	free
hcg	free
hch	free
hcs	taken
hcn	free
hco	free
hcx	free
hcu	free
hcr	free
hdb	taken
hcq	free
hct	free
hdc	taken
hcy	free
hcz	free
hcv	free
hcw	free
hdk	taken
hdl	taken
hda	free
hdg	free
hdd	free
hde	free
hdf	free
hdn	free
hdh	free
hdr	taken
hdi	free
hds	taken
hdj	free
hdt	taken
hdp	free
hdm	free
hea	taken
hdo	free
hdu	free
hdw	free
hed	taken
hdq	free
heb	free
hdv	free
hdx	free
hdy	free
hdz	free
hei	taken
hej	taken
hek	taken
hel	taken
hem	taken
hee	free
hef	free
hen	taken
hec	free
her	taken
het	taken
hew	taken
hex	taken
hey	taken
heg	free
heh	free
hep	free
heq	free
hes	free
hfb	taken
hfc	taken
hev	free
heo	free
hez	free
heu	free
hfa	free
hfd	free
hfe	free
hfh	free
hfj	free
hff	free
hfk	free
hfg	free
hfl	free
hfi	free
hfm	free
hfn	free
hfs	taken
hfo	free
hfq	free
hfr	free
hfp	free
hgc	taken
hfy	free
hfv	free
hge	taken
hft	free
hfu	free
hfz	free
hga	free
hfw	free
hfx	free
hgf	taken
hgd	free
hgb	free
hgj	free
hgl	free
hgm	free
hgh	free
hgn	free
hgs	taken
hgi	free
hgg	free
hgk	free
hgo	free
hgq	free
hgp	free
hgt	free
hgu	free
hha	taken
hgv	free
hgw	free
hgy	free
hgr	free
hhh	taken
hgx	free
hhb	free
hhc	free
hhl	taken
hgz	free
hhi	free
hhd	free
hhj	free
hhe	free
hhf	free
hhp	taken
hhg	free
hhm	free
hht	taken
hhv	taken
hhn	free
hhk	free
hhq	free
hia	taken
hhu	free
hhw	free
hho	free
hid	taken
hhz	free
hhr	free
hig	taken
hhs	free
hii	taken
hhx	free
hil	taken
him	taken
hie	free
hhy	free
hib	free
hio	taken
hip	taken
hic	free
hir	taken
his	taken
hik	free
hit	taken
hiv	taken
hif	free
hih	free
hij	free
hin	free
hix	free
hiw	free
hiz	free
hiq	free
hja	free
hiu	free
hiy	free
hjj	taken
hjb	free
hjk	taken
hjd	free
hjc	free
hje	free
hjg	free
hjh	free
hjs	taken
hjf	free
hji	free
hjm	free
hjo	free
hjp	free
hjx	taken
hjr	free
hjl	free
hjn	free
hjt	free
hju	free
hjq	free
hjw	free
hjy	free
hjv	free
hkd	free
hke	free
hkf	free
hjz	free
hka	free
hkb	free
hkc	free
hkg	free
hki	free
hkk	free
hkh	free
hkm	free
hkj	free
hkl	free
hkn	free
hko	free
hkp	free
hkq	free
hks	free
hkw	free
hkr	free
hky	free
hkx	free
hlc	taken
hkt	free
hku	free
hkv	free
hkz	free
hle	free
hld	free
hlf	free
hll	taken
hlb	free
hla	free
hlm	taken
hlh	free
hlg	free
hls	taken
hli	free
hlj	free
hlk	free
hln	free
hly	taken
hlr	free
hlu	free
hlo	free
hlp	free
hlq	free
hlv	free
hmb	taken
hlx	free
hmd	taken
hlt	free
hmh	taken
hlw	free
hmc	free
hme	free
hlz	free
hma	free
hmm	taken
hmi	free
hmj	free
hmk	free
hmr	taken
hmf	free
hms	taken
hmg	free
hmu	taken
hmn	free
hmq	free
hml	free
hmo	free
hmv	free
hmp	free
hmw	free
hmx	free
hnc	taken
hng	taken
hmt	free
hnb	free
hmy	free
hmz	free
hnd	free
hna	free
hnh	free
hnj	free
hnp	taken
hnk	free
hnf	free
hne	free
hnr	taken
hnl	free
hni	free
hns	taken
hnm	free
hno	free
hnw	taken
hny	taken
hnq	free
hnn	free
hoc	taken
hnt	free
hnv	free
hod	taken
hoe	taken
hof	taken
hog	taken
hnx	free
hnz	free
hoa	free
hnu	free
hoi	taken
hom	taken
hon	taken
hoo	taken
hop	taken
hos	taken
hoh	free
hob	free
hot	taken
hou	taken
how	taken
hoy	taken
hol	free
hoq	free
hok	free
hoj	free
hov	free
hor	free
hpa	free
hpb	free
hpc	free
hox	free
hpi	taken
hoz	free
hpm	taken
hpg	free
hpd	free
hph	free
hpp	taken
hpq	taken
hpe	free
hpk	free
hps	taken
hpf	free
hpn	free
hpv	taken
hpy	taken
hpj	free
hpl	free
hpt	free
hpo	free
hpw	free
hpr	free
hpu	free
hqb	free
hpx	free
hqd	free
hpz	free
hqa	free
hqf	free
hqc	free
hqh	free
hqe	free
hqq	taken
hqg	free
hqm	free
hqn	free
hqi	free
hqj	free
hqo	free
hqk	free
hql	free
hqx	taken
hqp	free
hqr	free
hqs	free
hqv	free
hrc	taken
hqw	free
hrf	taken
hqz	free
hqt	free
hrb	free
hqu	free
hqy	free
hre	free
hra	free
hrg	free
hrm	taken
hrn	taken
hrh	free
hrp	taken
hrk	free
hrd	free
hrj	free
hrl	free
hrt	taken
hrw	taken
hri	free
hrs	free
hru	free
hro	free
hrx	free
hrq	free
hsc	taken
hrr	free
hsa	free
hrv	free
hsf	taken
hsh	taken
hry	free
hsk	taken
hsl	taken
hrz	free
hsm	taken
hse	free
hsb	free
hsi	free
hsr	taken
hsj	free
hss	taken
hsd	free
hst	taken
hsu	taken
hso	free
hsp	free
hsg	free
hsx	taken
htc	taken
htd	taken
hsn	free
hsq	free
hsy	free
hta	free
htb	free
hsw	free
hsv	free
hte	free
hsz	free
htg	free
htm	taken
hto	taken
hth	free
hti	free
htf	free
htj	free
htk	free
htt	taken
htx	taken
htq	free
hts	free
htl	free
htn	free
hua	taken
htp	free
hub	taken
htr	free
hud	taken
hue	taken
hty	free
htu	free
hug	taken
htv	free
hui	taken
huh	taken
htw	free
huk	taken
hum	taken
hun	taken
huo	taken
hup	taken
hus	taken
htz	free
huf	free
hut	taken
huc	free
hul	free
huz	taken
huq	free
hur	free
hvb	taken
huj	free
huu	free
huv	free
huw	free
hux	free
hvc	free
hvd	free
huy	free
hve	free
hva	free
hvm	taken
hvj	free
hvf	free
hvg	free
hvh	free
hvi	free
hvl	free
hvk	free
hvn	free
hvp	free
hvo	free
hvu	free
hvq	free
hwa	taken
hvr	free
hvs	free
hvt	free
hwb	free
hvv	free
hvw	free
hvx	free
hvz	free
hvy	free
hwe	free
hwc	free
hwd	free
hwg	free
hwf	free
hwj	free
hwk	free
hwh	free
hwi	free
hwn	free
hwl	free
hwm	free
hws	free
hwo	free
hwp	free
hwu	free
hwq	free
hwr	free
hwx	free
hxd	taken
hwv	free
hwz	free
hww	free
hwt	free
hxc	free
hwy	free
hxe	free
hxa	free
hxb	free
hxf	free
hxj	free
hxp	taken
hxk	free
hxg	free
hxi	free
hxm	free
hxl	free
hxh	free
hxx	taken
hxr	free
hxn	free
hxo	free
hxs	free
hxv	free
hxq	free
hyb	taken
hyc	taken
hxt	free
hxw	free
hxu	free
hxz	free
hyk	taken
hxy	free
hyf	free
hya	free
hyn	taken
hyh	free
hyj	free
hyo	taken
hye	free
hyd	free
hyp	taken
hyg	free
hym	free
hyr	free
hyi	free
hyl	free
hyu	free
hyv	free
hyw	free
hyx	free
hyq	free
hyz	free
hyy	free
hys	free
hyt	free
hzb	free
hzd	free
hze	free
hza	free
hzc	free
hzi	free
hzj	free
hzf	free
hzg	free
hzh	free
hzl	free
hzm	free
hzn	free
hzp	free
hzk	free
hzq	free
hzy	taken
hzs	free
hzz	taken
hzo	free
hzu	free
iab	taken
hzv	free
iac	taken
hzr	free
hzt	free
iai	taken
hzw	free
iaa	free
iak	taken
hzx	free
iam	taken
iae	free
iaf	free
iah	free
iag	free
ian	taken
iap	taken
ias	taken
iat	taken
iad	free
iaj	free
ial	free
iau	free
iaw	free
iao	free
iaq	free
ibc	taken
iar	free
iav	free
ibf	taken
iax	free
iaz	free
iay	free
ibk	taken
ibe	free
ibd	free
ibm	taken
ibg	free
iba	free
ibb	free
ibj	free
ibs	taken
ibl	free
ibu	taken
ibh	free
ibi	free
ibo	free
ibt	free
ibn	free
ibv	free
ibp	free
ibq	free
ibw	free
ibr	free
icc	taken
ice	taken
icf	taken
icg	taken
ici	taken
ibx	free
ick	taken
iby	free
ibz	free
icb	free
icm	taken
icd	free
ico	taken
icp	taken
icq	taken
ica	free
icr	taken
ics	taken
icu	taken
icl	free
icy	taken
ich	free
ida	taken
idb	taken
icj	free
ict	free
idd	taken
icn	free
ide	taken
icw	free
icx	free
idg	taken
idk	taken
icv	free
idl	taken
idm	taken
idc	free
idn	taken
icz	free
ido	taken
idp	taken
idr	taken
ids	taken
idi	free
idt	taken
idh	free
idx	taken
idj	free
idy	taken
iea	taken
idf	free
ied	taken
idq	free
idu	free
ieh	taken
idz	free
iee	free
idv	free
idw	free
ieb	free
iec	free
ief	free
iej	free
ieg	free
ies	taken
ien	free
iei	free
iek	free
iev	taken
ieo	free
iel	free
ieq	free
iem	free
iep	free
ieu	free
ier	free
ifc	taken
ifd	taken
iex	free
iey	free
ife	taken
iff	taken
iez	free
iet	free
ifb	free
ifm	taken
iew	free
ifn	taken
ifa	free
ifk	free
ifs	taken
ifg	free
ifp	free
ifi	free
ifj	free
ifh	free
ift	taken
ifl	free
ifr	free
ifu	taken
ifx	taken
ify	taken
ifo	free
ifq	free
igg	taken
ifz	free
igb	free
ige	free
ifv	free
ifw	free
igf	free
iga	free
igc	free
igd	free
ign	taken
igh	free
igo	taken
igi	free
igj	free
igk	free
igs	free
igl	free
igm	free
igp	free
igq	free
igr	free
igt	free
igu	free
igv	free
ihb	free
igy	free
ihe	free
ihf	free
igw	free
igx	free
iha	free
igz	free
ihc	free
ihd	free
ihg	taken
ihn	free
ihj	free
ihp	free
ihk	free
ihm	free
ihl	free
ihh	free
ihi	free
iho	free
ihq	free
ihr	free
iht	free
ihy	free
ihs	free
ihu	free
iif	taken
ihv	free
ihw	free
ihx	free
ihz	free
iia	free
iib	free
iii	taken
iid	free
iie	free
iic	free
iio	taken
iip	taken
iis	taken
iim	free
iig	free
iih	free
iik	free
iij	free
iil	free
iin	free
iit	free
iiq	free
iir	free
iiv	free
iiu	free
ija	free
iiw	free
iiy	free
iix	free
iiz	free
ijb	free
ijc	free
ijd	free
ije	free
ijf	free
ijh	free
iji	free
ijg	free
ijs	taken
ijm	free
ijj	free
ijp	free
ijk	free
ijq	free
ijl	free
ijn	free
ijo	free
ijt	free
ika	taken
ijr	free
ikb	taken
ijw	free
ijx	free
ike	taken
ijy	free
iju	free
ijv	free
ikd	free
ijz	free
ikf	free
ikj	free
ikc	free
ikl	free
ikg	free
ikh	free
iki	free
ikr	taken
ikn	free
iku	taken
ikk	free
iko	free
ikm	free
ikt	free
ila	taken
ikp	free
ikw	free
ikq	free
ilc	taken
ikx	free
ikz	free
iky	free
iks	free
ikv	free
ilk	taken
ilb	free
ill	taken
ild	free
ile	free
ilp	taken
ilf	free
ilg	free
ilj	free
ili	free
ilh	free
ilo	free
ilq	free
ily	taken
ilm	free
iln	free
ima	taken
ilt	free
ilr	free
ilu	free
ilw	free
imd	taken
ime	taken
ils	free
img	taken
ilz	free
imb	free
ilv	free
iml	taken
ilx	free
imm	taken
imp	taken
imf	free
imo	taken
imh	free
imc	free
imr	taken
ims	taken
imt	taken
imj	free
imn	free
imu	taken
imy	taken
imz	taken
imi	free
imq	free
ina	taken
inc	taken
ind	taken
imk	free
inf	taken
ing	taken
inh	taken
ini	taken
inj	taken
ink	taken
inl	taken
imw	free
inn	taken
ino	taken
inq	taken
int	taken
ins	taken
imx	free
imv	free
inu	taken
inv	taken
inb	free
inm	free
inz	taken
ine	free
inr	free
ioc	taken
iod	taken
ioh	taken
inx	free
inp	free
ioa	free
iob	free
ioi	taken
iok	taken
iol	taken
ioe	free
ioj	free
iom	taken
inw	free
iny	free
iog	free
ion	taken
iop	taken
ios	taken
ior	taken
iov	taken
iot	taken
iou	taken
ipa	taken
iof	free
ipc	taken
ioq	free
iox	free
ioz	free
ipb	free
ioo	free
iow	free
ioy	free
ipg	free
ipl	taken
ipd	free
ipm	taken
ipe	free
iph	free
ipf	free
ipi	free
ipo	taken
ipj	free
ipp	taken
ips	taken
ipt	taken
ipv	taken
ipy	taken
ipz	taken
ipk	free
ipq	free
ipx	free
ipw	free
ipn	free
ipr	free
iqa	free
iqc	free
ipu	free
iqb	free
iqd	free
iqh	free
iqg	free
iqf	free
iqe	free
iqk	free
iqm	free
iqs	taken
iqi	free
iqj	free
iql	free
iqq	free
iqn	free
iqr	free
iqo	free
iqp	free
ira	taken
irc	taken
iqu	free
iqx	free
ire	taken
irf	taken
iqt	free
iqz	free
iri	taken
iqv	free
irk	taken
iqw	free
irm	taken
iqy	free
irn	taken
iro	taken
irq	taken
irr	taken
irg	free
irb	free
irj	free
ird	free
irl	free
irx	taken
irh	free
isa	taken
irs	free
isc	taken
iru	free
irt	free
irw	free
irp	free
isf	taken
irz	free
isg	taken
iry	free
ish	taken
irv	free
isb	free
isk	taken
ism	taken
iso	taken
ise	free
isq	taken
iss	taken
ist	taken
isu	taken
isi	free
isx	taken
isy	taken
isd	free
isz	taken
isr	free
isj	free
isn	free
isl	free
isw	free
itc	taken
itd	taken
ith	taken
isp	free
isv	free
itb	free
ite	free
ita	free
itj	free
ito	taken
itm	free
itl	free
itr	taken
iti	free
itg	free
itf	free
its	taken
itt	taken
itv	taken
itw	taken
itk	free
itx	taken
ity	taken
itq	free
iuc	taken
itu	free
itn	free
iua	free
iui	taken
itp	free
iud	free
itz	free
iub	free
iue	free
iuf	free
iug	free
iun	taken
iuk	free
ium	free
iul	free
iuh	free
ius	taken
iuv	taken
iuj	free
iuo	free
iuq	free
iuu	free
iur	free
iux	free
iuy	free
iup	free
ive	taken
ivd	taken
iut	free
iuw	free
ivi	taken
ivc	free
iuz	free
iva	free
ivb	free
ivm	taken
ivf	free
ivr	taken
ivj	free
ivs	taken
ivg	free
ivh	free
ivn	free
ivq	free
ivp	free
ivk	free
ivl	free
ivo	free
ivy	taken
iwc	taken
ivt	free
ivz	free
ivu	free
ivv	free
ivw	free
ivx	free
iwa	free
iwb	free
iwe	free
iwg	free
iwd	free
iwi	free
iwj	free
iwo	taken
iwf	free
iwl	free
iwh	free
iws	taken
iwk	free
iwn	free
iwm	free
iwr	free
iwq	free
iwu	free
iwp	free
iwx	free
iwt	free
iwv	free
ixa	free
iww	free
ixb	free
ixc	free
iwy	free
iwz	free
ixd	free
ixh	free
ixj	free
ixe	free
ixl	free
ixk	free
ixo	taken
ixf	free
ixg	free
ixi	free
ixm	free
ixr	free
ixx	taken
ixs	free
iya	taken
ixv	free
ixn	free
ixw	free
ixp	free
ixq	free
ixt	free
ixu	free
ixy	free
ixz	free
iyb	free
iyf	free
iyc	free
iyd	free
iye	free
iyk	free
iyg	free
iyh	free
iyi	free
iyl	free
iyj	free
iyu	taken
iyn	free
iyp	free
iyq	free
iyr	free
iym	free
iyo	free
iza	taken
iyv	free
iyw	free
ize	taken
iys	free
iyt	free
iyz	free
izi	taken
izb	free
iyx	free
izc	free
iyy	free
izo	taken
izj	free
izd	free
izn	free
izp	free
izr	free
izf	free
izg	free
izh	free
izk	free
izl	free
izm	free
izt	free
izq	free
izy	taken
izz	taken
izs	free
jab	taken
jac	taken
jaf	taken
jag	taken
jah	taken
izx	free
jak	taken
izu	free
jal	taken
jae	free
izw	free
jam	taken
izv	free
jan	taken
jaj	free
jaa	free
jao	taken
jaq	taken
jad	free
jar	taken
jas	taken
jat	taken
jaw	taken
jax	taken
jay	taken
jaz	taken
jai	free
jbb	taken
jbf	taken
jap	free
jav	free
jbj	taken
jbc	free
jbe	free
jbg	free
jau	free
jbh	free
jba	free
jbd	free
jbi	free
jbk	free
jbn	free
jbo	free
jbl	free
jbq	free
jbt	taken
jbm	free
jbr	free
jbp	free
jbs	free
jbw	free
jbz	free
jcf	taken
jbu	free
jbv	free
jby	free
jbx	free
jch	taken
jcb	free
jcj	taken
jca	free
jcl	taken
jcc	free
jcn	taken
jcr	taken
jci	free
jcd	free
jck	free
jce	free
jco	free
jcp	free
jcg	free
jcx	taken
jcm	free
jct	free
jdb	taken
jcq	free
jdc	taken
jcs	free
jcu	free
jdd	taken
jcz	free
jcy	free
jcv	free
jdf	taken
jcw	free
jdg	taken
jdi	taken
jdk	taken
jdm	taken
jda	free
jdh	free
jds	taken
jdj	free
jdt	taken
jdp	free
jdq	free
jde	free
jdu	taken
jdx	taken
jdl	free
jdy	taken
jdo	free
jeb	taken
jdn	free
jed	taken
jdr	free
jee	taken
jef	taken
jdv	free
jdw	free
jdz	free
jea	free
jel	taken
jem	taken
jen	taken
jec	free
jep	taken
jes	taken
jet	taken
jej	free
jek	free
jex	taken
jeh	free
jeg	free
jei	free
jeq	free
jer	free
jey	taken
jez	taken
jfb	taken
jfc	taken
jew	free
jeo	free
jeu	free
jfa	free
jev	free
jfd	free
jfk	taken
jff	free
jfm	taken
jfh	free
jfp	taken
jfj	free
jfe	free
jfs	taken
jft	taken
jfg	free
jfl	free
jfi	free
jfn	free
jfx	taken
jfq	free
jfo	free
jfu	free
jfr	free
jfy	free
jfz	free
jga	free
jge	taken
jgb	free
jfv	free
jfw	free
jgl	taken
jgc	free
jgd	free
jgg	free
jgh	free
jgf	free
jgi	free
jgj	free
jgk	free
jgm	free
jgn	free
jgp	free
jgq	free
jgo	free
jgr	free
jgt	free
jgu	free
jgv	free
jgs	free
jgx	free
jgy	free
jgw	free
jhe	free
jhh	taken
jhi	taken
jhb	free
jgz	free
jha	free
jhf	free
jhd	free
jhc	free
jhm	taken
jhp	taken
jhr	taken
jht	taken
jhj	free
jhk	free
jhl	free
jhg	free
jhu	free
jhv	free
jhn	free
jho	free
jhq	free
jhy	free
jhs	free
jhw	free
jhx	free
jhz	free
jia	taken
jib	taken
jig	taken
jif	taken
jid	taken
jii	taken
jik	taken
jin	taken
jim	taken
jio	taken
jip	taken
jir	taken
jit	taken
jij	free
jic	free
jix	taken
jil	free
jiq	free
jis	free
jie	free
jih	free
jiu	free
jjc	taken
jiv	free
jiz	free
jja	free
jiw	free
jjb	free
jje	free
jiy	free
jjj	taken
jjf	free
jjh	free
jjd	free
jjg	free
jji	free
jjk	free
jjl	free
jjm	free
jjs	taken
jju	taken
jjv	taken
jjn	free
jjw	taken
jjr	free
jjo	free
jjp	free
jjt	free
jjq	free
jjx	free
jkf	taken
jka	free
jkc	free
jjy	free
jjz	free
jkb	free
jkl	taken
jkj	free
jkd	free
jke	free
jkg	free
jkh	free
jki	free
jkm	free
jkn	free
jku	taken
jkk	free
jko	free
jks	free
jkt	free
jkp	free
jkq	free
jkw	free
jkr	free
jky	free
jkv	free
jkx	free
jla	free
jkz	free
jli	taken
jlc	free
jle	free
jld	free
jlf	free
jlg	free
jlb	free
jlh	free
jlk	free
jls	taken
jlm	free
jll	free
jlp	free
jlj	free
jlr	free
jln	free
jlo	free
jlq	free
jlt	free
jlx	free
jly	free
jmd	taken
jlv	free
jlu	free
jmf	taken
jlw	free
jmb	free
jmc	free
jlz	free
jml	taken
jmm	taken
jma	free
jmo	taken
jmk	free
jmp	taken
jmi	free
jmj	free
jmq	taken
jme	free
jms	taken
jmt	taken
jmv	taken
jmg	free
jmn	free
jmh	free
jmx	taken
jne	taken
jmu	free
jmr	free
jmy	free
jnc	free
jmw	free
jni	taken
jnh	free
jnk	free
jnl	free
jnb	free
jmz	free
jna	free
jnd	free
jng	free
jnf	free
jnj	free
jno	free
jnn	free
jnm	free
jnq	free
jnp	free
jnt	free
jns	free
jnv	free
joa	taken
job	taken
joc	taken
joe	taken
jnx	free
jnu	free
jnr	free
jof	taken
jnw	free
jog	taken
joi	taken
jom	taken
jny	free
jon	taken
jnz	free
joo	taken
jop	taken
jos	taken
jot	taken
joj	free
jok	free
jou	taken
jod	free
joq	free
joy	taken
joh	free
jol	free
jor	free
jox	taken
jpa	taken
jpc	taken
jpf	taken
jow	free
joz	free
jov	free
jpb	free
jpm	taken
jpe	free
jpd	free
jpi	free
jpg	free
jpp	taken
jps	taken
jpj	free
jph	free
jpu	taken
jpo	free
jpk	free
jpl	free
jpr	free
jpn	free
jpt	free
jpq	free
jpv	free
jpx	free
jqa	free
jpw	free
jpy	free
jpz	free
jqe	free
jqf	free
jqb	free
jql	taken
jqm	taken
jqn	taken
jqc	free
jqd	free
jqg	free
jqk	free
jqt	taken
jqh	free
jqu	taken
jqi	free
jqj	free
jqq	free
jqx	taken
jqo	free
jqp	free
jqr	free
jrc	taken
jqs	free
jqw	free
jqy	free
jra	free
jrg	taken
jqz	free
jqv	free
jrd	free
jrf	free
jrb	free
jrh	free
jrj	free
jrk	free
jrl	free
jrp	taken
jre	free
jrs	taken
jrm	free
jrv	taken
jrn	free
jri	free
jro	free
jsa	taken
jsb	taken
jrr	free
jsc	taken
jsd	taken
jse	taken
jry	free
jsf	taken
jrq	free
jrz	free
jsg	taken
jrt	free
jsh	taken
jru	free
jsi	taken
jsj	taken
jrw	free
jsk	taken
jsl	taken
jsm	taken
jsn	taken
jrx	free
jso	taken
jsp	taken
jsq	taken
jst	taken
jsr	taken
jss	taken
jsu	taken
jsv	taken
jsw	taken
jsy	taken
jsx	taken
jtc	taken
jta	free
jtb	free
jtd	free
jtg	free
jth	free
jtl	taken
jtj	free
jti	free
jsz	free
jtr	taken
jtf	free
jte	free
jts	taken
jtm	free
jtp	free
jtk	free
jtt	free
jtu	free
jtn	free
jto	free
jtq	free
jud	taken
jtx	free
jue	taken
juf	taken
jug	taken
jtv	free
jtw	free
jui	taken
jul	taken
jub	free
jum	taken
jty	free
jun	taken
jua	free
juc	free
jtz	free
jur	taken
juj	free
juk	free
jus	taken
jut	taken
juu	taken
jux	taken
jup	free
jvc	taken
juv	free
juh	free
juo	free
juq	free
juz	free
juw	free
jvg	taken
jva	free
jvb	free
jvi	taken
jvm	taken
juy	free
jve	free
jvd	free
jvk	free
jvj	free
jvl	free
jvn	free
jvu	taken
jvf	free
jvo	free
jvh	free
jvp	free
jvr	free
jvt	free
jwa	taken
jvx	free
jvq	free
jvy	free
jvz	free
jwe	taken
jwf	taken
jvs	free
jvv	free
jvw	free
jwb	free
jwd	free
jwc	free
jwl	free
jwj	free
jwi	free
jwg	free
jwh	free
jwk	free
jws	taken
jwt	taken
jwu	taken
jwm	free
jwn	free
jwx	taken
jwo	free
jwp	free
jwq	free
jxa	taken
jxc	taken
jxd	taken
jxh	taken
jwy	free
jwr	free
jxb	free
jxj	taken
jwv	free
jxf	free
jxm	taken
jww	free
jwz	free
jxr	taken
jxe	free
jxg	free
jxi	free
jxs	taken
jxk	free
jxt	taken
jxl	free
jxo	free
jxx	taken
jxp	free
jxn	free
jxu	free
jxv	free
jxq	free
jxw	free
jxz	free
jyg	taken
jya	free
jyb	free
jyj	taken
jxy	free
jyc	free
jye	free
jyf	free
jyh	free
jyd	free
jyl	free
jyt	taken
jyi	free
jyk	free
jyq	free
jym	free
jyx	taken
jyn	free
jys	free
jyo	free
jyr	free
jyp	free
jyu	free
jyw	free
jza	free
jyv	free
jyz	free
jze	free
jzf	free
jyy	free
jzb	free
jzc	free
jzd	free
jzj	free
jzh	free
jzg	free
jzl	free
jzi	free
jzo	free
jzp	free
jzk	free
jzm	free
jzq	free
jzs	free
jzn	free
jzz	taken
kaa	taken
jzt	free
kab	taken
kad	taken
jzu	free
jzr	free
jzv	free
jzx	free
kai	taken
kaj	taken
kak	taken
kal	taken
jzw	free
kan	taken
kao	taken
kag	free
jzy	free
kac	free
kat	taken
kae	free
kah	free
kaf	free
kay	taken
kam	free
kaq	free
kar	free
kap	free
kav	free
kax	free
kas	free
kbb	taken
kbd	taken
kba	free
kau	free
kaw	free
kaz	free
kbc	free
kbf	free
kbj	free
kbg	free
kbe	free
kbh	free
kbi	free
kbn	free
kbk	free
kbl	free
kbp	free
kbq	free
kbm	free
kbo	free
kbr	free
kbs	free
kbu	free
kcc	taken
kbv	free
kbw	free
kbt	free
kbx	free
kbz	free
kby	free
kcb	free
kcd	free
kce	free
kcf	free
kcg	free
kca	free
kch	free
kcp	taken
kcj	free
kcs	taken
kcl	free
kcm	free
kcn	free
kci	free
kck	free
kcq	free
kcr	free
kct	free
kco	free
kcv	free
kdc	taken
kde	taken
kdf	taken
kcu	free
kcw	free
kcx	free
kdg	taken
kcy	free
kcz	free
kdi	taken
kda	free
kdd	free
kdb	free
kdk	taken
kdp	taken
kdt	taken
kdh	free
kdm	free
kdl	free
kdo	free
kdq	free
kdj	free
kdr	free
kdn	free
kea	taken
kdu	free
kds	free
kdv	free
kee	taken
kdx	free
keg	taken
kdw	free
kec	free
kdy	free
kdz	free
kek	taken
kel	taken
kem	taken
keh	free
ken	taken
keb	free
ked	free
keo	taken
kej	free
kes	taken
kef	free
kew	taken
kev	taken
kex	taken
key	taken
kei	free
kfa	taken
kfc	taken
keq	free
keu	free
kff	taken
kep	free
ker	free
kfb	free
ket	free
kfe	free
kfd	free
kez	free
kfh	free
kfi	free
kfg	free
kfl	free
kfm	free
kfs	taken
kfn	free
kfo	free
kfj	free
kfp	free
kfk	free
kfw	taken
kfr	free
kgb	taken
kgc	taken
kft	free
kfq	free
kge	taken
kfy	free
kfz	free
kfu	free
kga	free
kfv	free
kfx	free
kgf	free
kgh	free
kgg	free
kgd	free
kgo	taken
kgk	free
kgl	free
kgm	free
kgi	free
kgj	free
kgq	free
kgp	free
kgr	free
kgn	free
kgs	free
kgw	free
kgx	free
kgy	free
kgu	free
kgt	free
khb	free
kgv	free
khf	taken
kgz	free
khc	free
kha	free
khe	free
khg	free
khj	free
khk	free
khd	free
khh	free
khi	free
khl	free
khm	free
kho	free
khp	free
khn	free
kht	free
khu	free
khr	free
khq	free
khx	free
kib	taken
khs	free
kid	taken
kif	taken
khz	free
khv	free
khw	free
kik	taken
khy	free
kil	taken
kio	taken
kie	free
kim	taken
kin	taken
kip	taken
kir	taken
kis	taken
kia	free
kic	free
kit	taken
kih	free
kig	free
kix	taken
kii	free
kij	free
kiq	free
kiz	free
kja	free
kiu	free
kjc	free
kjd	free
kiv	free
kiy	free
kiw	free
kje	free
kjb	free
kjj	free
kjn	free
kjm	free
kjf	free
kjg	free
kjo	free
kji	free
kjh	free
kjk	free
kjs	taken
kjl	free
kju	taken
kjv	taken
kka	taken
kjq	free
kjr	free
kjw	free
kjx	free
kjp	free
kjz	free
kjt	free
kkb	free
kkc	free
kkd	free
kkk	taken
kjy	free
kke	free
kkj	free
kkh	free
kkf	free
kkg	free
kki	free
kkl	free
kkn	free
kkq	free
kko	free
kkm	free
kkp	free
kla	taken
kku	free
kks	free
kkw	free
kkr	free
kky	free
kkx	free
kld	taken
klb	free
klc	free
kkt	free
kkv	free
kkz	free
klf	free
klg	free
kle	free
klj	free
klh	free
klo	free
kli	free
kls	taken
klk	free
klp	free
kll	free
klm	free
klv	taken
kln	free
klq	free
klt	free
klw	free
kmc	taken
klr	free
kmd	taken
kmf	taken
kma	free
klz	free
klu	free
kmi	taken
kly	free
klx	free
kml	taken
kmb	free
kmm	taken
kmp	taken
kmg	free
kms	taken
kmt	taken
kmk	free
kme	free
kmq	free
kmh	free
kmr	free
kmj	free
kmn	free
kmo	free
kmu	free
kmw	free
kmv	free
kne	taken
kng	taken
kmx	free
kmy	free
kna	free
kmz	free
kni	taken
knb	free
knn	taken
knc	free
knd	free
knh	free
kns	taken
knf	free
knp	free
knq	free
knk	free
knj	free
knr	free
knl	free
kno	free
knm	free
knx	taken
koa	taken
kob	taken
knt	free
koc	taken
kod	taken
koe	taken
knu	free
koi	taken
kny	free
knw	free
knz	free
koo	taken
kom	taken
knv	free
koh	free
koj	free
kop	taken
kor	taken
kos	taken
kok	free
kof	free
kov	taken
kog	free
kon	free
kow	taken
kox	taken
kol	free
kot	free
kou	free
kpf	taken
kpg	taken
koq	free
kpa	free
kpd	free
kpc	free
kpi	taken
kpe	free
kpm	taken
koz	free
koy	free
kpb	free
kph	free
kpt	taken
kpl	free
kpn	free
kpp	free
kpw	taken
kpj	free
kpk	free
kpr	free
kpo	free
kpq	free
kpv	free
kps	free
kpy	free
kpx	free
kpz	free
kqb	free
kpu	free
kqa	free
kqf	free
kqc	free
kqh	free
kqk	free
kqd	free
kqi	free
kqj	free
kqe	free
kqg	free
kql	free
kqn	free
kqq	free
kqo	free
kqr	free
kqs	free
kqm	free
kqp	free
kqt	free
krd	taken
kqx	free
kqu	free
kqz	free
kra	free
kqv	free
kre	free
kqw	free
kqy	free
krk	taken
krc	free
krb	free
kro	taken
kri	free
krl	free
krf	free
krg	free
krh	free
krj	free
krr	free
krm	free
krn	free
krp	free
krq	free
ksa	taken
kru	free
krs	free
krx	free
krt	free
kry	free
krv	free
krw	free
ksh	taken
ksd	free
krz	free
ksb	free
ksc	free
ksi	free
ksj	free
ksp	taken
ksl	free
kse	free
ksg	free
ksf	free
ksm	free
kss	taken
kst	taken
ksk	free
ksn	free
ksq	free
ksr	free
ksu	free
ksv	free
kso	free
ksw	free
ktc	taken
ktf	taken
ksy	free
ksx	free
ksz	free
kta	free
ktl	taken
kth	free
ktb	free
kti	free
kte	free
ktd	free
ktg	free
ktk	free
kts	taken
ktm	free
ktv	taken
ktn	free
kto	free
ktj	free
ktq	free
kua	taken
kub	taken
ktu	free
ktp	free
kud	taken
kue	taken
ktr	free
kty	free
ktz	free
ktt	free
kui	taken
kuc	free
ktw	free
ktx	free
kuf	free
kun	taken
kug	free
kup	taken
kuo	taken
kuk	free
kus	taken
kul	free
kuu	taken
kum	free
kuh	free
kuy	taken
kuj	free
kuq	free
kut	free
kvc	taken
kvd	taken
kuw	free
kur	free
kva	free
kvb	free
kux	free
kuv	free
kvf	free
kuz	free
kvi	free
kvj	free
kve	free
kvg	free
kvk	free
kvh	free
kvl	free
kvm	free
kvs	taken
kvr	free
kvq	free
kvn	free
kvo	free
kvt	free
kvx	free
kvp	free
kwe	taken
kvu	free
kvv	free
kvw	free
kwc	free
kvy	free
kvz	free
kwa	free
kwf	free
kwb	free
kwi	free
kwh	free
kwl	taken
kwd	free
kwg	free
kwk	free
kwm	free
kwt	taken
kwj	free
kwr	free
kws	free
kwn	free
kwo	free
kwp	free
kwq	free
kwu	free
kwv	free
kww	free
kwy	free
kxb	free
kwx	free
kxe	free
kwz	free
kxf	free
kxg	free
kxk	taken
kxa	free
kxc	free
kxd	free
kxi	free
kxh	free
kxn	free
kxo	free
kxj	free
kxl	free
kxm	free
kxp	free
kxt	free
kxq	free
kxr	free
kxu	free
kxs	free
kxx	free
kxv	free
kya	free
kyb	free
kxw	free
kyd	free
kxy	free
kye	free
kxz	free
kyc	free
kyo	taken
kyi	free
kyj	free
kyf	free
kyg	free
kyr	taken
kyl	free
kyn	free
kyh	free
kyt	taken
kyu	taken
kyk	free
kym	free
kyq	free
kys	free
kyw	free
kyx	free
kyp	free
kyz	free
kyv	free
kzc	free
kyy	free
kzd	free
kza	free
kzb	free
kze	free
kzf	free
kzg	free
kzl	free
kzh	free
kzi	free
kzk	free
kzj	free
kzt	taken
kzm	free
kzn	free
kzp	free
kzr	free
kzs	free
kzo	free
lab	taken
kzq	free
kzv	free
lac	taken
kzy	free
kzu	free
laa	free
lae	taken
lag	taken
lah	taken
kzx	free
kzw	free
lai	taken
laj	taken
lam	taken
lad	free
lan	taken
kzz	free
lao	taken
lap	taken
lar	taken
las	taken
laf	free
lau	taken
lat	taken
law	taken
lax	taken
lay	taken
lak	free
laz	taken
lal	free
laq	free
lbb	taken
lbc	taken
lbf	taken
lav	free
lbj	taken
lbm	taken
lba	free
lbd	free
lbg	free
lbe	free
lbk	free
lbp	taken
lbr	taken
lbs	taken
lbi	free
lbh	free
lbl	free
lbn	free
lbo	free
lbw	free
lbq	free
lby	free
lbx	free
lbt	free
lbu	free
lcd	taken
lbz	free
lbv	free
lcg	taken
lcl	taken
lcb	free
lca	free
lcm	taken
lcp	taken
lci	free
lcj	free
lck	free
lcc	free
lcr	taken
lcs	taken
lce	free
lcf	free
lcn	free
lch	free
lda	taken
lct	free
lcu	free
ldb	taken
lco	free
lcv	free
lcw	free
ldc	taken
lcy	free
lcq	free
ldf	taken
ldl	taken
lcx	free
ldm	taken
lcz	free
ldd	free
ldp	taken
ldg	free
ldi	free
ldk	free
ldj	free
ldr	taken
lds	taken
lde	free
ldt	taken
ldn	free
ldh	free
ldy	taken
lea	taken
leb	taken
lec	taken
ldu	free
led	taken
ldo	free
lee	taken
lef	taken
ldq	free
leg	taken
ldz	free
lei	taken
ldv	free
lel	taken
lem	taken
ldw	free
len	taken
ldx	free
leo	taken
les	taken
lev	taken
lej	free
leh	free
let	taken
lew	taken
lex	taken
lfa	taken
lek	free
ler	free
lfd	taken
leu	free
lep	free
leq	free
ley	free
lfb	free
lfc	free
lfe	free
lez	free
lfh	free
lfo	taken
lfj	free
lfk	free
lff	free
lfg	free
lfl	free
lfr	taken
lfm	free
lfs	taken
lfn	free
lfi	free
lfp	free
lfy	taken
lga	taken
lgd	taken
lfu	free
lfv	free
lft	free
lfq	free
lfz	free
lgg	taken
lgc	free
lfw	free
lfx	free
lge	free
lgh	free
lgb	free
lgk	free
lgp	taken
lgl	free
lgm	free
lgf	free
lgr	taken
lgs	taken
lgn	free
lgi	free
lgj	free
lgo	free
lgq	free
lhb	taken
lhc	taken
lgu	free
lgv	free
lgx	free
lgz	free
lgy	free
lha	free
lhf	taken
lhh	taken
lgt	free
lhj	taken
lgw	free
lhd	free
lhe	free
lhg	free
lhk	free
lhl	free
lhs	taken
lho	free
lhq	free
lhi	free
lhm	free
lhn	free
lhy	taken
lhp	free
lia	taken
lib	taken
lhr	free
lhw	free
lic	taken
lid	taken
lie	taken
lht	free
lif	taken
lhu	free
lig	taken
lhv	free
lii	taken
lik	taken
lil	taken
lim	taken
lin	taken
lhx	free
lip	taken
lir	taken
lhz	free
lit	taken
liu	taken
liv	taken
lix	taken
liz	taken
liq	free
lih	free
lis	free
lij	free
liw	free
lio	free
lja	free
ljh	taken
liy	free
ljb	free
ljg	free
ljc	free
ljd	free
ljf	free
lje	free
ljl	free
ljr	taken
ljs	taken
lji	free
ljn	free
ljj	free
ljk	free
ljq	free
ljm	free
ljo	free
ljz	taken
ljp	free
ljv	free
ljx	free
ljt	free
lju	free
ljw	free
ljy	free
lkh	taken
lkd	free
lkk	taken
lka	free
lkl	taken
lkb	free
lkc	free
lke	free
lkj	free
lkf	free
lkr	taken
lkg	free
lki	free
lkm	free
lko	free
lks	free
lkn	free
lkp	free
lkt	free
lkq	free
lku	free
lkv	free
llb	free
lla	free
lkw	free
llc	free
lld	free
lky	free
lkx	free
lkz	free
lll	taken
llh	free
lli	free
lle	free
llf	free
llq	taken
llg	free
lln	free
lls	taken
llk	free
llt	taken
llo	free
llj	free
llm	free
llr	free
lmc	taken
llu	free
llp	free
lmd	taken
lly	free
lme	taken
lmb	free
lmi	taken
llv	free
llx	free
llw	free
llz	free
lma	free
lmg	free
lmf	free
lmh	free
lml	free
lmn	free
lmr	taken
lms	taken
lmj	free
lmk	free
lmm	free
lmo	free
lmp	free
lmq	free
lmv	free
lmw	free
lnc	taken
lmy	free
lmx	free
lnd	taken
lmt	free
lmu	free
lna	free
lnf	taken
lng	taken
lni	taken
lnk	taken
lnm	taken
lmz	free
lnb	free
lnr	taken
lnh	free
lns	taken
lnj	free
lnl	free
lnt	taken
lnn	free
lno	free
lne	free
loa	taken
lnq	free
lob	taken
loc	taken
lod	taken
lnp	free
loe	taken
lnv	free
lnw	free
lny	free
log	taken
lol	taken
lom	taken
lnu	free
lnx	free
lon	taken
lop	taken
loo	taken
loj	free
loi	free
lor	taken
los	taken
lnz	free
lot	taken
lou	taken
lov	taken
low	taken
lox	taken
loh	free
lok	free
lof	free
lpd	taken
lpf	taken
loy	free
loq	free
loz	free
lpb	free
lpe	free
lpc	free
lpm	taken
lpg	free
lpa	free
lpj	free
lpk	free
lph	free
lpt	taken
lpi	free
lpq	free
lpr	free
lpl	free
lpo	free
lpn	free
lpp	free
lpu	free
lpv	free
lps	free
lqd	taken
lpw	free
lqa	free
lqb	free
lqc	free
lpy	free
lpx	free
lpz	free
lqf	free
lqg	free
lqh	free
lqi	free
lqj	free
lqe	free
lqk	free
lqm	free
lqn	free
lqo	free
lqq	free
lql	free
lqs	free
lqy	taken
lqt	free
lqp	free
lqu	free
lqv	free
lrc	taken
lqr	free
lqx	free
lqz	free
lri	taken
lra	free
lrb	free
lrd	free
lre	free
lqw	free
lrf	free
lrl	taken
lrg	free
lrh	free
lrs	taken
lru	taken
lrp	free
lrq	free
lrr	free
lrj	free
lrk	free
lrm	free
lrz	taken
lrn	free
lsa	taken
lro	free
lsb	taken
lsc	taken
lsd	taken
lsf	taken
lrt	free
lsg	taken
lrw	free
lrx	free
lry	free
lsk	taken
lsl	taken
lsm	taken
lrv	free
lsn	taken
lsp	taken
lsq	taken
lsr	taken
lss	taken
lse	free
lst	taken
lsi	free
lsj	free
lsx	taken
ltc	taken
lsh	free
ltd	taken
lsu	free
lsw	free
ltg	taken
lso	free
lta	free
ltb	free
lti	taken
lsv	free
ltk	taken
lte	free
lsz	free
ltl	taken
lsy	free
ltr	taken
lts	taken
ltt	taken
ltf	free
lth	free
ltv	taken
ltq	free
ltj	free
ltx	taken
ltu	free
lua	taken
ltm	free
ltn	free
lto	free
ltp	free
luc	taken
luf	taken
ltw	free
lug	taken
lui	taken
luk	taken
lum	taken
lud	free
lty	free
lue	free
luo	taken
lub	free
ltz	free
luj	free
lul	free
lut	taken
luu	taken
luv	taken
luh	free
lux	taken
lup	free
lus	free
lun	free
luy	free
luq	free
lur	free
lva	free
lvb	free
luw	free
luz	free
lvf	free
lvc	free
lvi	free
lve	free
lvd	free
lvk	free
lvl	taken
lvg	free
lvh	free
lvj	free
lvm	taken
lvt	free
lvn	free
lvw	free
lvp	free
lvv	free
lvu	free
lvq	free
lvo	free
lvr	free
lvs	free
lvx	free
lwa	free
lvz	free
lwb	free
lwf	free
lwd	free
lvy	free
lwg	free
lwc	free
lwe	free
lwl	taken
lwk	free
lwn	free
lwp	free
lwo	free
lwq	free
lwj	free
lwr	free
lwh	free
lwi	free
lwm	free
lws	taken
lwt	taken
lxc	taken
lxd	taken
lww	free
lxa	free
lxb	free
lxf	free
lwy	free
lwv	free
lwx	free
lwu	free
lwz	free
lxj	taken
lxl	taken
lxp	taken
lxg	free
lxe	free
lxm	free
lxh	free
lxi	free
lxu	taken
lxr	free
lxx	taken
lxk	free
lxn	free
lxo	free
lxy	taken
lxq	free
lyd	taken
lye	taken
lxs	free
lxt	free
lyg	taken
lxz	free
lya	free
lyc	free
lxv	free
lxw	free
lyl	taken
lyf	free
lym	taken
lyn	taken
lyh	free
lyp	taken
lyb	free
lyq	taken
lyr	taken
lys	taken
lyk	free
lyi	free
lyo	free
lyj	free
lyu	free
lyy	free
lyt	free
lza	free
lyv	free
lzb	free
lyw	free
lyx	free
lzc	free
lzf	taken
lzg	taken
lzh	taken
lzd	free
lyz	free
lzo	taken
lzq	taken
lzs	taken
lzi	free
lzj	free
lzk	free
lze	free
lzl	free
lzp	free
lzw	taken
lzy	taken
lzz	taken
maa	taken
lzn	free
lzm	free
mac	taken
mad	taken
lzt	free
mae	taken
maf	taken
lzv	free
lzr	free
mag	taken
mai	taken
mak	taken
mal	taken
mam	taken
man	taken
mao	taken
lzu	free
map	taken
maq	taken
mar	taken
lzx	free
mas	taken
mat	taken
mau	taken
maw	taken
max	taken
may	taken
mab	free
mbc	taken
mbf	taken
mah	free
maj	free
mav	free
maz	free
mba	free
mbd	free
mbl	taken
mbo	taken
mbh	free
mbb	free
mbi	free
mbe	free
mbj	free
mbr	taken
mbs	taken
mbt	taken
mbm	free
mbg	free
mbk	free
mbq	free
mca	taken
mbn	free
mbv	free
mbw	free
mcc	taken
mbx	free
mcd	taken
mbp	free
mbz	free
mcf	taken
mcg	taken
mbu	free
mck	taken
mcl	taken
mcm	taken
mcb	free
mby	free
mco	taken
mcp	taken
mce	free
mci	free
mcr	taken
mch	free
mcs	taken
mct	taken
mcu	taken
mcn	free
mcz	taken
mda	taken
mdb	taken
mdc	taken
mcj	free
mdd	taken
mde	taken
mdf	taken
mdg	taken
mdi	taken
mcv	free
mcw	free
mdj	taken
mcy	free
mcq	free
mcx	free
mdl	taken
mdm	taken
mdn	taken
mdo	taken
mdp	taken
mdr	taken
mds	taken
mdt	taken
mdv	taken
mdw	taken
mdh	free
mdx	taken
mdy	taken
mdz	taken
mdk	free
med	taken
mee	taken
mef	taken
mdq	free
meg	taken
meh	taken
mei	taken
mek	taken
mel	taken
mem	taken
men	taken
meo	taken
mes	taken
met	taken
mdu	free
mea	free
mew	taken
mec	free
meb	free
mex	taken
meq	free
mej	free
mfb	taken
mfc	taken
mev	free
mep	free
mer	free
mfe	taken
mff	taken
mfg	taken
mez	free
mfi	taken
mfk	taken
meu	free
mfl	taken
mfm	taken
mfp	taken
mey	free
mfa	free
mfs	taken
mfh	free
mft	taken
mfj	free
mfd	free
mfw	taken
mfn	free
mfo	free
mfq	free
mfr	free
mfu	free
mfy	free
mgg	taken
mgd	free
mfv	free
mfx	free
mfz	free
mgi	taken
mga	free
mgb	free
mgc	free
mgn	taken
mge	free
mgo	taken
mgp	taken
mgr	taken
mgs	taken
mgf	free
mgh	free
mgl	free
mgm	free
mgj	free
mgt	free
mgk	free
mgw	free
mgq	free
mhd	taken
mgu	free
mgv	free
mhf	taken
mgx	free
mhb	free
mhc	free
mgy	free
mgz	free
mhe	free
mhm	taken
mha	free
mhg	free
mhh	free
mhi	free
mhj	free
mhk	free
mhl	free
mht	taken
mhn	free
mho	free
mhq	free
mia	taken
mhr	free
mhu	free
mhp	free
mib	taken
mic	taken
mid	taken
mie	taken
mig	taken
mhv	free
mhs	free
mii	taken
mhw	free
mhx	free
mhy	free
mik	taken
mim	taken
min	taken
mhz	free
mio	taken
mip	taken
miq	taken
mir	taken
mis	taken
mit	taken
miu	taken
mih	free
mix	taken
mif	free
mil	free
mij	free
miw	free
miv	free
miy	free
miz	free
mjb	free
mje	free
mja	free
mjc	free
mjg	free
mjh	free
mjd	free
mjo	taken
mjf	free
mjl	free
mjs	taken
mji	free
mjk	free
mjj	free
mjp	free
mjm	free
mjn	free
mjt	free
mjq	free
mjx	free
mjr	free
mkb	taken
mkc	taken
mkd	taken
mjv	free
mju	free
mkg	taken
mjw	free
mjz	free
mkk	taken
mjy	free
mkf	free
mka	free
mkp	taken
mkh	free
mki	free
mkj	free
mkl	free
mkm	free
mkr	taken
mke	free
mks	taken
mkt	taken
mkn	free
mko	free
mla	taken
mlb	taken
mlc	taken
mle	taken
mkq	free
mlf	taken
mlh	taken
mky	free
mkv	free
mku	free
mkw	free
mkx	free
mkz	free
mlg	free
mll	taken
mli	free
mln	taken
mlo	taken
mld	free
mlp	taken
mlk	free
mlt	taken
mls	taken
mlm	free
mlj	free
mlq	free
mma	taken
mmb	taken
mlv	free
mlw	free
mmc	taken
mlx	free
mmd	taken
mlz	free
mmf	taken
mmg	taken
mlr	free
mlu	free
mml	taken
mmm	taken
mly	free
mmo	taken
mmp	taken
mmq	taken
mms	taken
mmi	free
mme	free
mmh	free
mmr	free
mmj	free
mmk	free
mmt	free
mmy	taken
mmu	free
mmn	free
mmv	free
mnd	taken
mng	taken
mmw	free
mmz	free
mnb	free
mmx	free
mnh	free
mna	free
mnm	taken
mnc	free
mne	free
mnf	free
mnj	free
mnl	free
mns	taken
mni	free
mnt	taken
mnn	free
mnk	free
mnr	free
moa	taken
mno	free
mnp	free
mnu	free
mnq	free
mnw	free
mob	taken
moc	taken
mod	taken
mnz	free
moe	taken
mof	taken
mog	taken
moh	taken
moi	taken
mnv	free
mok	taken
mol	taken
mnx	free
mom	taken
mon	taken
moo	taken
mny	free
mop	taken
mor	taken
mos	taken
mot	taken
mou	taken
mov	taken
mow	taken
mox	taken
moy	taken
moz	taken
mpa	taken
mpc	taken
mpd	taken
moj	free
mpe	taken
mpg	taken
mph	taken
mpi	taken
moq	free
mpm	taken
mpn	taken
mpq	taken
mpr	taken
mps	taken
mpf	free
mpv	taken
mpj	free
mpl	free
mpo	free
mpb	free
mpp	free
mpk	free
mpu	free
mpw	free
mpt	free
mpx	free
mqd	free
mpy	free
mpz	free
mqa	free
mqb	free
mqc	free
mql	taken
mqe	free
mqf	free
mqh	free
mqg	free
mqr	taken
mqt	taken
mqi	free
mqj	free
mqk	free
mqm	free
mqq	free
mqn	free
mqo	free
mqs	free
mqp	free
mqv	free
mqw	free
mqx	free
mqy	free
mqz	free
mrg	taken
mrb	free
mri	taken
mqu	free
mrc	free
mrk	taken
mrl	taken
mra	free
mrd	free
mrm	taken
mrn	taken
mrh	free
mrs	taken
mrt	taken
mru	taken
mre	free
mrf	free
mrx	taken
mrz	taken
mrp	free
msa	taken
mrj	free
msb	taken
msc	taken
mse	taken
mro	free
mrr	free
mrq	free
msg	taken
mry	free
msh	taken
mrv	free
msm	taken
mrw	free
msn	taken
msf	free
msi	free
msk	free
msd	free
msp	taken
msr	taken
mss	taken
mst	taken
msu	taken
msv	taken
msl	free
msx	taken
msj	free
msz	taken
mta	taken
mso	free
mtc	taken
mtd	taken
mtg	taken
mtk	taken
msw	free
msy	free
mtb	free
mtl	taken
mtm	taken
msq	free
mte	free
mth	free
mtp	taken
mtr	taken
mti	free
mts	taken
mtt	taken
mtf	free
mtx	taken
mtj	free
mua	taken
mto	free
mtq	free
mtz	taken
mub	taken
mud	taken
mue	taken
mtn	free
mtv	free
mtu	free
mug	taken
mui	taken
muk	taken
mum	taken
mun	taken
mtw	free
mup	taken
muc	free
mty	free
muf	free
mus	taken
mut	taken
muj	free
mul	free
mux	taken
muo	free
muz	taken
mva	taken
muh	free
muq	free
mur	free
mvb	taken
mvc	taken
muu	free
mve	taken
muw	free
mvi	taken
mvm	taken
muv	free
mvn	taken
mvd	free
mvg	free
muy	free
mvo	taken
mvp	taken
mvj	free
mvk	free
mvr	taken
mvl	free
mvu	taken
mvx	taken
mvh	free
mvf	free
mwb	taken
mwc	taken
mvq	free
mwd	taken
mvs	free
mwf	taken
mvv	free
mvt	free
mwe	free
mvw	free
mvy	free
mvz	free
mwg	free
mwa	free
mwh	free
mwl	taken
mwm	taken
mwj	free
mwr	taken
mws	taken
mwi	free
mwo	free
mwp	free
mwt	free
mwu	free
mwk	free
mww	free
mxa	taken
mwn	free
mwx	free
mxd	taken
mwq	free
mwv	free
mwy	free
mwz	free
mxc	free
mxb	free
mxl	taken
mxf	free
mxi	free
mxj	free
mxe	free
mxk	free
mxh	free
mxg	free
mxt	taken
mxn	free
mxm	free
mxo	free
mxx	taken
mxp	free
mxy	taken
mxu	free
mya	taken
mxq	free
mxw	free
mxr	free
myf	taken
mxs	free
mxv	free
myk	taken
myb	free
mym	taken
myg	free
mxz	free
myn	taken
myc	free
myo	taken
mye	free
myd	free
myr	taken
myh	free
myl	free
myi	free
myj	free
myx	taken
myp	free
myq	free
mys	free
myt	free
myu	free
myy	free
mza	free
mzg	taken
myv	free
myz	free
myw	free
mze	free
mzf	free
mzc	free
mzb	free
mzd	free
mzh	free
mzi	free
mzj	free
mzk	free
mzl	free
mzm	free
mzn	free
mzp	free
mzu	free
mzo	free
mzq	free
mzv	free
mzr	free
mzs	free
mzt	free
mzy	free
nab	taken
nac	taken
mzw	free
nad	taken
mzx	free
nae	taken
naf	taken
nag	taken
naa	free
nah	taken
nai	taken
nak	taken
nam	taken
nao	taken
nan	taken
nap	taken
nar	taken
nat	taken
nau	taken
nav	taken
mzz	free
nay	taken
nba	taken
naj	free
nbc	taken
nbd	taken
nbe	taken
nas	free
nal	free
naq	free
nbb	free
nax	free
naw	free
nbg	free
nbm	taken
nbn	taken
naz	free
nbi	free
nbp	taken
nbs	taken
nbf	free
nbl	free
nbk	free
nbh	free
nbt	taken
nbj	free
nca	taken
nbu	free
nbv	free
nbw	free
nbo	free
nby	free
nbx	free
nbq	free
ncc	taken
nbr	free
nce	taken
ncf	taken
nci	taken
ncg	taken
nck	taken
ncl	taken
nbz	free
ncm	taken
ncn	taken
nco	taken
ncp	taken
ncr	taken
ncd	free
ncs	taken
ncu	taken
nct	taken
nch	free
ncb	free
ndb	taken
ncq	free
ndd	taken
ncj	free
nde	taken
ncy	free
ndf	taken
nda	free
ndi	taken
ndj	taken
ncv	free
ndk	taken
ncx	free
ncw	free
ndl	taken
ndm	taken
ncz	free
ndo	taken
ndr	taken
nds	taken
ndc	free
ndt	taken
ndu	taken
ndh	free
ndv	taken
ndx	taken
neb	taken
ndn	free
ndg	free
ndp	free
ned	taken
nee	taken
nef	taken
ndy	free
nei	taken
nej	taken
nec	free
ndq	free
nek	taken
nel	taken
nem	taken
neo	taken
ndw	free
nep	taken
nea	free
ndz	free
ner	taken
nes	taken
net	taken
neu	taken
nev	taken
new	taken
nex	taken
nez	taken
nfa	taken
nfb	taken
neg	free
nfc	taken
neh	free
nfd	taken
nff	taken
nfe	taken
nfj	taken
nfl	taken
nfm	taken
nen	free
ney	free
neq	free
nfo	taken
nfn	free
nfs	taken
nfg	free
nfk	free
nfp	free
nfr	free
nfh	free
nfi	free
nfy	taken
nfu	free
nga	taken
ngb	taken
nfv	free
ngc	taken
nfw	free
nfq	free
ngf	taken
nft	free
ngh	taken
ngi	taken
ngl	taken
ngm	taken
nfz	free
ngn	taken
nfx	free
ngd	free
ngo	taken
ngg	free
ngs	taken
ngt	taken
ngk	free
ngv	taken
ngx	taken
nge	free
ngp	free
ngj	free
ngu	free
ngq	free
ngy	free
ngz	free
ngr	free
nhg	taken
ngw	free
nhc	free
nhl	taken
nha	free
nhb	free
nhn	taken
nhh	free
nhd	free
nhe	free
nhj	free
nhp	taken
nhs	taken
nhf	free
nhi	free
nhm	free
nho	free
nhk	free
nhq	free
nhr	free
nht	free
nia	taken
nib	taken
nhv	free
nid	taken
nic	taken
nie	taken
nif	taken
nih	taken
nii	taken
nij	taken
nhu	free
nhz	free
nik	taken
nim	taken
nil	taken
nhw	free
nin	taken
nio	taken
nip	taken
nhy	free
nhx	free
nir	taken
nis	taken
niu	taken
nit	taken
nig	free
nix	taken
niy	free
niz	free
njb	free
njd	free
niq	free
nje	free
niv	free
niw	free
nja	free
njc	free
njm	taken
njo	taken
njq	taken
njf	free
nji	free
njk	free
njg	free
njs	taken
njv	taken
njh	free
njl	free
njj	free
njx	taken
njn	free
njr	free
njt	free
njp	free
nju	free
nkd	free
njw	free
nkf	free
njy	free
nkg	free
njz	free
nka	free
nkb	free
nkc	free
nke	free
nkk	taken
nkm	taken
nko	taken
nkj	free
nks	taken
nkl	free
nkn	free
nkq	free
nkh	free
nki	free
nkp	free
nkr	free
nlb	taken
nkv	free
nld	taken
nkw	free
nkt	free
nlf	taken
nkz	free
nla	free
nku	free
nlg	taken
nlc	free
nli	taken
nlk	taken
nkx	free
nky	free
nlm	taken
nlo	taken
nle	free
nlp	taken
nls	taken
nlt	taken
nll	free
nln	free
nlq	free
nlr	free
nlh	free
nlz	taken
nlj	free
nlu	free
nma	taken
nmb	taken
nmc	taken
nmd	taken
nme	taken
nmf	taken
nmg	taken
nmh	taken
nmi	taken
nly	free
nml	taken
nmm	taken
nlv	free
nlw	free
nlx	free
nmo	taken
nmp	taken
nmq	taken
nmr	taken
nms	taken
nmt	taken
nmv	taken
nmj	free
nmw	taken
nnb	taken
nnd	taken
nmk	free
nmu	free
nnf	taken
nmn	free
nmz	free
nmy	free
nna	free
nng	taken
nnc	free
nnj	taken
nnm	taken
nnn	taken
nnp	taken
nmx	free
nns	taken
nne	free
nnu	taken
nnl	free
nno	free
nnq	free
nnx	taken
nnr	free
nni	free
nnh	free
nnk	free
noa	taken
nob	taken
noc	taken
nod	taken
noe	taken
nof	taken
nog	taken
noh	taken
noi	taken
nnt	free
nny	free
nol	taken
nom	taken
non	taken
noo	taken
nop	taken
noq	taken
nnv	free
nor	taken
nnw	free
nos	taken
not	taken
nov	taken
now	taken
nnz	free
nox	taken
noj	free
noz	taken
npa	taken
npb	taken
npc	taken
npd	taken
npg	taken
npf	taken
npe	taken
nph	taken
npi	taken
nok	free
npk	taken
npl	taken
npn	taken
npo	taken
npm	taken
npp	taken
npr	taken
nps	taken
npt	taken
npu	taken
npv	taken
nou	free
npx	taken
npy	taken
npj	free
noy	free
npw	free
nqa	free
nqb	free
nqc	free
npq	free
nqe	free
nqh	taken
nqg	free
npz	free
nqd	free
nqf	free
nqk	free
nqm	free
nqo	free
nqi	free
nql	free
nqj	free
nqq	free
nqn	free
nqp	free
nra	taken
nqu	free
nqr	free
nrc	taken
nrd	taken
nqs	free
nqz	free
nqy	free
nqt	free
nre	taken
nrf	taken
nrg	taken
nri	taken
nqv	free
nrj	taken
nrk	taken
nqw	free
nqx	free
nrm	taken
nrb	free
nrp	taken
nrs	taken
nrh	free
nrx	taken
nrn	free
nru	free
nrv	free
nrl	free
nsa	taken
nro	free
nrq	free
nsc	taken
nrt	free
nrr	free
nry	free
nsf	taken
nrz	free
nrw	free
nsh	taken
nsi	taken
nsl	taken
nsm	taken
nsp	taken
nsq	taken
nse	free
nsg	free
nsr	taken
nsb	free
nst	taken
nsj	free
nss	taken
nsk	free
nso	free
nsd	free
nsn	free
ntc	taken
nte	taken
nsu	free
ntf	taken
nta	free
nsz	free
ntb	free
nth	taken
nsv	free
ntk	taken
ntl	taken
nsw	free
nsx	free
nsy	free
ntm	taken
ntp	taken
ntr	taken
nts	taken
ntd	free
ntt	taken
ntj	free
ntw	taken
ntg	free
ntn	free
nti	free
nub	taken
ntu	free
ntv	free
nuc	taken
ntx	free
nto	free
nue	taken
ntq	free
nug	taken
nua	free
nui	taken
nul	taken
nun	taken
num	taken
nty	free
nuo	taken
ntz	free
nup	taken
nut	taken
nuh	free
nuk	free
nuj	free
nud	free
nuw	taken
nux	taken
nuf	free
nva	taken
nuq	free
nur	free
nvb	taken
nvc	taken
nus	free
nvd	taken
nvi	taken
nuu	free
nuv	free
nvl	taken
nvf	free
nvg	free
nuy	free
nvh	free
nvm	taken
nvn	taken
nuz	free
nvj	free
nvp	taken
nvt	taken
nve	free
nvk	free
nvu	free
nvo	free
nvy	free
nvq	free
nvr	free
nwb	taken
nvs	free
nvv	free
nvw	free
nwd	taken
nwf	taken
nvx	free
nwk	taken
nvz	free
nwm	taken
nwn	taken
nwo	taken
nwa	free
nwp	taken
nwq	taken
nwc	free
nwr	taken
nws	taken
nwe	free
nwv	taken
nwg	free
nwh	free
nwj	free
nwt	taken
nwi	free
nwl	free
nxe	taken
nww	free
nwz	free
nxb	free
nwu	free
nxf	free
nwx	free
nwy	free
nxc	free
nxm	taken
nxd	free
nxa	free
nxg	free
nxp	taken
nxj	free
nxt	taken
nxk	free
nxh	free
nxl	free
nxi	free
nxo	free
nxr	free
nxs	free
nya	taken
nxn	free
nyb	taken
nyc	taken
nxq	free
nxv	free
nyg	taken
nxy	free
nxz	free
nyi	taken
nxu	free
nyd	free
nxw	free
nxx	free
nye	free
nym	taken
nyf	free
nyh	free
nyr	taken
nyk	free
nyl	free
nyt	taken
nyu	taken
nyj	free
nyx	taken
nys	free
nyn	free
nyo	free
nyq	free
nyp	free
nyw	free
nyy	free
nyv	free
nzh	taken
nzb	free
nzc	free
nze	free
nzd	free
nza	free
nzf	free
nzg	free
nyz	free
nzi	free
nzk	free
nzl	free
nzn	free
nzq	free
nzj	free
nzs	free
nzm	free
nzp	free
nzr	free
oaa	taken
nzo	free
nzx	free
nzt	free
nzz	free
nzv	free
nzu	free
oaf	taken
nzw	free
oac	free
oai	taken
oak	taken
nzy	free
oae	free
oao	taken
oab	free
oad	free
oap	taken
oar	taken
oas	taken
oat	taken
oaj	free
oav	taken
oag	free
oah	free
oay	taken
oaq	free
oal	free
oam	free
oba	taken
oan	free
obd	taken
oaw	free
oax	free
obi	taken
oaz	free
obj	taken
oau	free
obb	free
obg	free
obc	free
obk	free
obp	taken
obl	free
obq	taken
obe	free
obm	free
obf	free
obo	free
obh	free
obs	taken
obv	taken
obx	taken
oca	taken
obn	free
ocd	taken
obr	free
ocf	taken
obt	free
obz	free
ocb	free
oce	free
obu	free
obw	free
oby	free
ocl	taken
ocg	free
occ	free
oco	taken
ocp	taken
ocj	free
ocr	taken
oct	taken
och	free
oci	free
ock	free
ocm	free
ocn	free
oda	taken
ocq	free
odb	taken
ocs	free
ocu	free
ocv	free
odd	taken
ode	taken
ocw	free
ocx	free
ocy	free
odc	free
ocz	free
odg	free
odm	taken
odn	taken
odo	taken
odj	free
odk	free
odp	taken
odl	free
ods	taken
odt	taken
odf	free
odh	free
odi	free
odq	free
odu	free
odv	free
odr	free
oea	free
odw	free
odx	free
ody	free
oec	free
odz	free
oeb	free
oee	free
oed	free
oeh	free
oei	free
oel	free
oef	free
oeg	free
oes	taken
oej	free
oek	free
oem	free
oen	free
oep	free
oet	free
ofa	taken
oeo	free
oeq	free
oer	free
ofe	taken
oex	free
oeu	free
oev	free
oez	free
off	taken
oew	free
oey	free
ofc	free
ofg	free
ofb	free
ofd	free
ofj	free
ofh	free
ofm	free
ofn	free
ofi	free
ofo	taken
ofk	free
ofl	free
oft	taken
ofx	taken
ofp	free
ofr	free
ofs	free
ofv	free
ofy	free
ofq	free
ogg	taken
ofu	free
ofw	free
ogb	free
ogh	taken
ofz	free
oga	free
ogd	free
oge	free
ogm	taken
ogc	free
ogp	taken
ogf	free
ogl	free
ogi	free
ogn	free
ogj	free
ogk	free
ogv	taken
ogq	free
ogs	free
ogo	free
ogt	free
ogu	free
ogr	free
ohc	taken
ogw	free
ogx	free
ogy	free
ohe	free
ohf	free
oha	free
ogz	free
ohg	free
ohh	free
ohm	taken
ohb	free
ohj	free
oho	taken
ohd	free
oht	taken
ohi	free
ohk	free
ohl	free
ohp	free
ohq	free
oia	taken
ohv	free
ohn	free
ohw	free
ohr	free
ohx	free
ohs	free
oic	taken
oid	taken
ohu	free
ohz	free
oil	taken
oib	free
ohy	free
oie	free
oif	free
oio	taken
oij	free
oih	free
oig	free
oii	free
oik	free
oin	free
oiq	free
oim	free
oip	free
oiv	free
ois	free
oiw	free
oir	free
oit	free
oja	taken
oiy	free
ojc	taken
oiu	free
oix	free
ojb	free
oiz	free
ojg	free
oje	free
ojd	free
ojm	taken
oji	free
ojo	taken
ojf	free
ojj	free
ojs	taken
ojh	free
ojt	taken
ojk	free
ojn	free
ojp	free
oka	taken
ojr	free
ojl	free
okc	taken
oju	free
ojq	free
ojx	free
oke	taken
ojy	free
ojv	free
ojw	free
ojz	free
okh	free
okb	free
okd	free
oko	taken
okf	free
okg	free
oki	free
okm	free
okj	free
okk	free
okn	free
okl	free
okq	free
okr	free
oku	free
okp	free
okv	free
ola	taken
okx	free
oks	free
olc	taken
old	taken
ole	taken
okt	free
okz	free
olg	taken
okw	free
oli	taken
oky	free
oll	taken
olm	taken
olo	taken
olf	free
olk	free
olb	free
olh	free
olj	free
oln	free
olr	free
olx	taken
oly	taken
olu	free
oma	taken
olp	free
olv	free
olq	free
omc	taken
omd	taken
omf	taken
olt	free
ols	free
omg	taken
omi	taken
oml	taken
olz	free
omm	taken
olw	free
ome	free
omh	free
omb	free
omk	free
oms	taken
omp	free
omj	free
omr	free
omn	free
omo	free
omq	free
omu	free
ona	taken
omx	free
one	taken
ong	taken
omv	free
omt	free
omw	free
onc	free
oni	taken
ond	free
omy	free
omz	free
onf	free
onb	free
onm	taken
ono	taken
onh	free
ons	taken
onk	free
onj	free
onx	taken
onp	free
ony	taken
onr	free
onl	free
onu	free
onn	free
onv	free
onw	free
onq	free
ont	free
onz	free
oob	free
ooc	taken
ooa	free
ood	taken
oof	taken
ook	taken
oom	taken
oog	taken
ooh	taken
ooj	taken
ooo	taken
oop	taken
ooq	taken
oor	taken
oos	taken
ool	free
ooi	free
oon	free
ooz	taken
opa	taken
ooe	free
oow	free
opc	taken
oox	free
ooy	free
ope	taken
opf	taken
opg	taken
oot	free
oou	free
oov	free
opl	taken
opb	free
opm	taken
opn	taken
opo	taken
opp	taken
opd	free
opq	taken
ops	taken
opt	taken
opi	free
opk	free
opx	taken
opj	free
oph	free
opu	free
opw	free
opz	free
oqa	free
opr	free
oqb	free
opv	free
opy	free
oqc	free
oqd	free
oqf	free
oqh	free
oqg	free
oqi	free
oqk	free
oqe	free
oqn	free
oqo	free
oqj	free
oql	free
oqm	free
oqq	free
oqr	free
oqt	free
ora	taken
orb	taken
oqv	free
orc	taken
oqp	free
oqs	free
ord	taken
ore	taken
org	taken
oqz	free
oqu	free
ori	taken
ork	taken
orm	taken
oqw	free
orn	taken
oqx	free
oro	taken
oqy	free
orh	free
ort	taken
orj	free
orl	free
orf	free
orp	free
orr	free
orz	taken
oru	free
osa	taken
osb	taken
osc	taken
osd	taken
orw	free
ose	taken
orq	free
osg	taken
ors	free
ory	free
osi	taken
osk	taken
osm	taken
osl	taken
orv	free
oso	taken
orx	free
osp	taken
osr	taken
osf	free
oss	taken
ost	taken
osu	taken
osj	free
osx	taken
osh	free
osn	free
osw	free
osy	free
osz	free
ota	free
osq	free
otc	free
osv	free
otl	taken
otd	free
otb	free
ote	free
otg	free
oth	free
otj	free
oto	taken
otp	taken
otr	taken
ots	taken
otf	free
otn	free
oti	free
otw	taken
otx	taken
otk	free
otm	free
otu	free
otq	free
oty	free
ott	free
ouc	free
oua	free
otv	free
oui	taken
oud	free
otz	free
oub	free
ouo	taken
ouh	free
oue	free
ouf	free
oug	free
our	taken
ouj	free
out	taken
ouk	free
oup	free
oul	free
oum	free
ouq	free
oun	free
ova	taken
ous	free
ove	taken
ouv	free
ouw	free
ouy	free
ouz	free
ovh	taken
ovb	free
ovc	free
ouu	free
ovl	taken
oux	free
ovo	taken
ovf	free
ovg	free
ovd	free
ovk	free
ovt	taken
ovm	free
ovn	free
ovi	free
ovj	free
ovr	free
ovy	taken
owa	taken
ovp	free
ovu	free
ovv	free
ovq	free
owe	taken
ovx	free
ovs	free
owg	taken
ovw	free
owb	free
owl	taken
owd	free
owf	free
ovz	free
own	taken
owo	taken
owk	free
owc	free
ows	taken
owt	taken
owh	free
owi	free
owq	free
owr	free
owm	free
owj	free
owu	free
owp	free
oxc	taken
oww	free
owv	free
owz	free
oxa	free
oxb	free
owx	free
oxi	taken
owy	free
oxd	free
oxl	taken
oxm	taken
oxe	free
oxo	taken
oxr	taken
oxj	free
oxf	free
oxg	free
oxk	free
oxn	free
oxh	free
oxy	taken
oxt	free
oxp	free
oxw	free
oxv	free
oxq	free
oxx	free
oxs	free
oye	taken
oxz	free
oxu	free
oyd	free
oya	free
oyh	free
oyb	free
oyk	free
oyc	free
oyg	free
oyf	free
oyi	free
oyj	free
oys	taken
oym	free
oyl	free
oyq	free
oyn	free
oyu	free
oyv	free
oyw	free
oyo	free
oyp	free
oyr	free
oyt	free
oyx	free
oyy	free
ozb	free
ozc	free
oyz	free
ozg	free
oza	free
ozh	free
ozd	free
oze	free
ozf	free
ozj	free
ozk	free
ozl	free
ozi	free
ozm	free
ozp	free
ozq	free
ozw	taken
ozr	free
ozt	free
ozn	free
ozo	free
ozz	taken
pad	taken
pac	taken
ozs	free
paf	taken
pag	taken
ozy	free
ozu	free
ozv	free
pai	taken
pal	taken
pak	taken
pab	free
pam	taken
pan	taken
ozx	free
pao	taken
pap	taken
paq	taken
par	taken
pas	taken
paa	free
pat	taken
paw	taken
pax	taken
pae	free
pay	taken
pah	free
paj	free
pav	free
pbf	taken
pbe	free
pau	free
paz	free
pbj	taken
pba	free
pbd	free
pbh	free
pbc	free
pbb	free
pbl	taken
pbn	taken
pbp	taken
pbr	taken
pbs	taken
pbg	free
pbk	free
pbi	free
pbx	taken
pca	taken
pbt	free
pbu	free
pcb	taken
pbv	free
pbw	free
pcc	taken
pbm	free
pbo	free
pcd	taken
pby	free
pbq	free
pcg	taken
pcl	taken
pcm	taken
pco	taken
pcp	taken
pbz	free
pcf	free
pci	free
pch	free
pcr	taken
pcs	taken
pct	taken
pcn	free
pce	free
pcw	taken
pck	free
pcj	free
pcq	free
pdc	taken
pdd	taken
pdf	taken
pcu	free
pdg	taken
pcx	free
pcy	free
pcz	free
pdi	taken
pdk	taken
pcv	free
pdl	taken
pde	free
pdp	taken
pdb	free
pda	free
pds	taken
pdt	taken
pdu	taken
pdn	free
pdh	free
pdj	free
pdr	free
pdq	free
pdm	free
pea	taken
pdo	free
ped	taken
pdw	free
pdx	free
pee	taken
pdy	free
peg	taken
pdz	free
peh	taken
pdv	free
peb	free
pem	taken
pec	free
pen	taken
pep	taken
per	taken
pek	free
pej	free
pet	taken
pel	free
pev	taken
pew	taken
pef	free
pex	taken
peq	free
peo	free
pez	taken
pei	free
pfe	taken
pff	taken
peu	free
pes	free
pfb	free
pfc	free
pfg	free
pfl	taken
pfm	taken
pey	free
pfh	free
pfp	taken
pfj	free
pfa	free
pfd	free
pfs	taken
pft	taken
pfi	free
pfx	taken
pfy	taken
pfk	free
pfq	free
pgb	taken
pfu	free
pgc	taken
pge	taken
pfn	free
pfo	free
pfr	free
pfz	free
pfv	free
pfw	free
pgl	taken
pgf	free
pga	free
pgh	free
pgo	taken
pgk	free
pgd	free
pgq	taken
pgm	free
pgs	taken
pgg	free
pgi	free
pgj	free
pgx	taken
pgn	free
pgt	free
pgu	free
pgv	free
pgp	free
pgr	free
pgy	free
phe	taken
phi	taken
pgw	free
phb	free
pgz	free
pha	free
phl	taken
phg	free
pho	taken
phc	free
phd	free
php	taken
phf	free
phr	taken
pht	taken
phh	free
phm	free
phx	taken
phj	free
phy	taken
phk	free
pia	taken
phq	free
phs	free
pic	taken
phu	free
pid	taken
phn	free
pie	taken
phv	free
pif	taken
phw	free
pig	taken
pil	taken
pik	taken
pin	taken
pio	taken
pim	taken
pip	taken
pib	free
piq	taken
pir	taken
pit	taken
piu	taken
piv	taken
pix	taken
pih	free
pii	free
phz	free
pij	free
piy	taken
pis	free
piw	free
pja	free
pjb	free
pjf	free
pje	free
piz	free
pjh	free
pjc	free
pjg	free
pjd	free
pjl	free
pjm	free
pji	free
pjs	taken
pjj	free
pjn	free
pjk	free
pjp	free
pjo	free
pjy	taken
pjt	free
pjr	free
pjq	free
pjw	free
pjz	free
pka	free
pkg	taken
pju	free
pjx	free
pjv	free
pkb	free
pkc	free
pkh	free
pkm	taken
pke	free
pkd	free
pkf	free
pkp	taken
pkk	free
pkl	free
pkr	taken
pks	taken
pki	free
pku	taken
pkn	free
pkx	taken
pkj	free
pla	taken
pkt	free
pko	free
plc	taken
ple	taken
pkv	free
pkw	free
pkq	free
plh	taken
pli	taken
pll	taken
plm	taken
pky	free
pkz	free
pln	taken
plf	free
plp	taken
plg	free
plb	free
plr	taken
pld	free
pls	taken
plu	taken
ply	taken
plx	taken
plj	free
plk	free
plz	taken
pmb	taken
pma	taken
pmc	taken
plq	free
pmd	taken
pme	taken
pmf	taken
plo	free
pmi	taken
plv	free
pml	taken
pmp	taken
plt	free
plw	free
pmm	taken
pmg	free
pmq	taken
pmj	free
pmk	free
pms	taken
pmt	taken
pmn	free
pmv	taken
pmo	free
pmx	taken
pmh	free
pmu	free
pnf	taken
pnb	free
pmr	free
pnd	free
png	taken
pmw	free
pmy	free
pmz	free
pna	free
pnc	free
pnm	taken
pne	free
pnp	taken
pni	free
pnj	free
pns	taken
pnk	free
pnt	taken
pnh	free
pnn	free
pnv	free
pnl	free
pnr	free
pob	taken
pno	free
poc	taken
pnu	free
pnq	free
pod	taken
poe	taken
pog	taken
poi	taken
poa	free
pnw	free
pom	taken
pnx	free
pon	taken
pny	free
poo	taken
pnz	free
pop	taken
pof	free
poh	free
pos	taken
por	taken
pot	taken
pov	taken
pol	free
pow	taken
pox	taken
pok	free
poj	free
poq	free
pou	free
ppf	taken
ppg	taken
poy	free
poz	free
ppi	taken
ppc	free
ppd	free
ppl	taken
ppm	taken
ppn	taken
ppo	taken
ppe	free
ppp	taken
ppq	taken
ppa	free
ppr	taken
ppb	free
pps	taken
pph	free
ppt	taken
ppj	free
ppx	taken
ppk	free
ppu	free
ppw	free
ppv	free
ppy	free
ppz	free
pqb	free
pqa	free
pqc	free
pqd	free
pqf	free
pqg	free
pqe	free
pqj	free
pql	free
pqs	taken
pqh	free
pqi	free
pqk	free
pqn	free
pqm	free
pqq	free
pqo	free
pqp	free
pqt	free
pqu	free
pqr	free
pqv	free
pqx	free
pqy	free
pqz	free
pre	taken
prf	taken
prb	free
prg	taken
prh	taken
pqw	free
prj	taken
prm	taken
pro	taken
prp	taken
pra	free
prr	taken
prs	taken
prt	taken
pru	taken
prc	free
prd	free
prl	free
prx	taken
pry	taken
psa	taken
prq	free
psb	taken
pri	free
psc	taken
psd	taken
pse	taken
prk	free
prn	free
psg	taken
prw	free
psh	taken
psi	taken
psj	taken
psk	taken
psl	taken
prz	free
psm	taken
psn	taken
pso	taken
psp	taken
psq	taken
psr	taken
pss	taken
pst	taken
prv	free
psx	taken
psy	taken
psf	free
psw	free
ptb	free
pte	free
psu	free
psv	free
pta	free
psz	free
ptc	free
ptd	free
ptg	free
pth	free
pto	taken
ptp	taken
ptf	free
ptr	taken
ptk	free
pts	taken
ptt	taken
ptn	free
ptv	taken
pti	free
pty	taken
ptj	free
ptm	free
pua	taken
ptl	free
pub	taken
puc	taken
ptu	free
puf	taken
pug	taken
ptx	free
ptq	free
pui	taken
ptz	free
pul	taken
pum	taken
pun	taken
ptw	free
pup	taken
pud	free
pur	taken
pus	taken
put	taken
puu	taken
pue	free
puq	free
puh	free
puj	free
puk	free
puo	free
pvc	taken
pve	taken
puv	free
puw	free
pux	free
puy	free
pva	free
pvb	free
pvd	free
puz	free
pvm	taken
pvp	taken
pvh	free
pvq	taken
pvj	free
pvf	free
pvt	taken
pvo	free
pvg	free
pvi	free
pvk	free
pvn	free
pvl	free
pvr	free
pvs	free
pwa	taken
pwc	taken
pwd	taken
pvv	free
pvw	free
pvx	free
pvu	free
pvy	free
pvz	free
pwg	free
pwb	free
pwm	taken
pwe	free
pwn	taken
pwh	free
pwf	free
pwk	free
pws	taken
pwi	free
pwj	free
pwp	free
pwl	free
pwz	taken
pww	free
pwx	free
pwo	free
pwq	free
pwr	free
pxa	taken
pxb	taken
pwt	free
pwu	free
pwv	free
pwy	free
pxl	taken
pxc	free
pxe	free
pxg	free
pxi	free
pxp	taken
pxj	free
pxd	free
pxf	free
pxm	free
pxh	free
pxt	taken
pxk	free
pxx	taken
pxy	taken
pxn	free
pya	taken
pxq	free
pxs	free
pxo	free
pxv	free
pxw	free
pyd	taken
pyf	taken
pxr	free
pxz	free
pxu	free
pyb	free
pym	taken
pye	free
pyn	taken
pyg	free
pyo	taken
pyi	free
pyj	free
pys	taken
pyc	free
pyt	taken
pyh	free
pyx	taken
pyp	free
pyz	taken
pyk	free
pyr	free
pyl	free
pyq	free
pyy	free
pyu	free
pyw	free
pyv	free
pza	free
pzc	free
pzb	free
pzd	free
pze	free
pzh	free
pzf	free
pzg	free
pzl	free
pzk	free
pzi	free
pzj	free
pzn	free
pzw	taken
pzr	free
pzm	free
pzp	free
pzo	free
pzq	free
pzs	free
pzt	free
pzu	free
pzv	free
pzz	free
qab	free
qae	free
qaf	free
pzx	free
pzy	free
qaa	free
qam	taken
qac	free
qad	free
qah	free
qag	free
qap	taken
qai	free
qaj	free
qas	taken
qal	free
qak	free
qao	free
qaz	taken
qau	free
qav	free
qan	free
qaq	free
qax	free
qar	free
qat	free
qaw	free
qbb	free
qay	free
qbe	free
qba	free
qbi	free
qbd	free
qbc	free
qbf	free
qbg	free
qbh	free
qbl	free
qbs	taken
qbj	free
qbk	free
qbn	free
qbo	free
qbq	free
qbt	free
qbu	free
qbm	free
qbp	free
qbv	free
qbr	free
qbx	free
qby	free
qca	free
qcb	free
qcc	free
qbw	free
qcd	free
qbz	free
qce	free
qck	taken
qcm	taken
qcf	free
qcn	free
qcg	free
qch	free
qco	free
qcq	free
qci	free
qcj	free
qcl	free
qcp	free
qcr	free
qdb	taken
qcw	free
qcx	free
qcz	free
qcs	free
qct	free
qcu	free
qcv	free
qcy	free
qda	free
qde	free
qdc	free
qdl	taken
qdf	free
qdg	free
qdh	free
qdd	free
qdq	taken
qdj	free
qdi	free
qdu	taken
qdp	free
qdk	free
qdr	free
qds	free
qdm	free
qdo	free
qdn	free
qea	taken
qdv	free
qed	taken
qee	taken
qdt	free
qdx	free
qdz	free
qdw	free
qdy	free
qel	taken
qeh	free
qeg	free
qeb	free
qei	free
qej	free
qef	free
qeq	taken
qec	free
qem	free
qen	free
qek	free
qew	taken
qes	free
qet	free
qep	free
qeo	free
qer	free
qev	free
qeu	free
qfe	taken
qfa	free
qfi	taken
qfd	free
qex	free
qey	free
qez	free
qff	free
qfb	free
qfc	free
qfh	free
qfg	free
qfs	taken
qfj	free
qfl	free
qfm	free
qfk	free
qfn	free
qfq	free
qfo	free
qfp	free
qfr	free
qfu	free
qfv	free
qfw	free
qfx	free
qfy	free
qfz	free
qft	free
qgd	free
qge	free
qga	free
qgb	free
qgc	free
qgo	taken
qgf	free
qgh	free
qgg	free
qgi	free
qgl	free
qgm	free
qgj	free
qgp	free
qgk	free
qgn	free
qgt	free
qgw	free
qgq	free
qgs	free
qgr	free
qgx	free
qhc	taken
qgv	free
qgu	free
qhf	taken
qha	free
qhb	free
qgy	free
qgz	free
qhd	free
qhe	free
qhi	free
qhl	free
qhm	free
qhh	free
qhg	free
qhp	free
qht	taken
qhq	free
qhj	free
qhk	free
qhn	free
qhr	free
qhw	free
qho	free
qhx	free
qhs	free
qhy	free
qhu	free
qhz	free
qhv	free
qie	taken
qif	taken
qia	free
qib	free
qii	taken
qid	free
qim	taken
qin	taken
qiq	taken
qig	free
qij	free
qil	free
qic	free
qit	taken
qis	taken
qih	free
qik	free
qir	free
qio	free
qip	free
qiw	free
qiu	free
qix	free
qjb	free
qiv	free
qiy	free
qjc	free
qiz	free
qja	free
qje	free
qjf	free
qjd	free
qjg	free
qjj	free
qjn	free
qjh	free
qji	free
qjs	taken
qjk	free
qjo	free
qjl	free
qjp	free
qjq	free
qjm	free
qjr	free
qju	free
qjv	free
qka	free
qjt	free
qjw	free
qjx	free
qjy	free
qjz	free
qkb	free
qke	free
qkc	free
qkg	free
qkd	free
qkj	free
qkf	free
qkl	free
qkh	free
qkr	taken
qki	free
qkk	free
qkm	free
qkp	free
qko	free
qkn	free
qkt	free
qkv	free
qku	free
qkq	free
qkw	free
qks	free
qky	free
qkz	free
qla	free
qlb	free
qkx	free
qlc	free
qld	free
qle	free
qlf	free
qlj	free
qll	free
qlm	free
qlg	free
qln	free
qlh	free
qli	free
qlk	free
qlp	taken
qlo	free
qlt	taken
qlw	free
qlq	free
qma	free
qls	free
qlu	free
qlv	free
qlx	free
qlr	free
qly	free
qlz	free
qmb	taken
qmd	taken
qmc	free
qmf	free
qmh	free
qme	free
qmj	free
qmm	free
qmg	free
qmk	free
qmi	free
qml	free
qms	taken
qmo	free
qmv	free
qmx	free
qmu	free
qmq	free
qmr	free
qmn	free
qmp	free
qmt	free
qmw	free
qna	taken
qnd	taken
qne	taken
qng	taken
qnc	free
qnb	free
qmz	free
qnf	free
qnh	free
qni	free
qnj	free
qnp	taken
qns	taken
qmy	free
qnk	free
qnn	free
qnl	free
qno	free
qnx	taken
qnz	taken
qnm	free
qnr	free
qnq	free
qnw	free
qnt	free
qny	free
qod	taken
qnu	free
qnv	free
qoc	free
qoa	free
qoe	free
qob	free
qog	free
qoh	free
qoo	taken
qoj	free
qok	free
qop	taken
qof	free
qos	taken
qoi	free
qon	free
qol	free
qoq	free
qor	free
qot	free
qom	free
qow	free
qou	free
qpc	taken
qov	free
qpd	taken
qoy	free
qox	free
qpa	free
qoz	free
qpe	free
qpg	free
qpi	free
qpm	taken
qpb	free
qpk	free
qpp	taken
qpf	free
qpr	taken
qph	free
qps	taken
qpj	free
qpo	free
qpl	free
qpn	free
qpt	free
qpw	free
qpv	free
qpx	free
qpq	free
qpu	free
qqc	free
qpy	free
qpz	free
qqe	free
qqa	free
qqh	free
qqb	free
qqd	free
qqf	free
qqg	free
qqi	free
qqq	taken
qql	free
qqm	free
qqo	free
qqj	free
qqk	free
qqp	free
qqr	free
qqs	free
qqn	free
qqu	free
qrc	taken
qqw	free
qqt	free
qqy	free
qqv	free
qqx	free
qqz	free
qre	free
qra	free
qrb	free
qrf	free
qrd	free
qrh	free
qrk	free
qrg	free
qrl	free
qri	free
qrs	taken
qro	free
qrj	free
qrm	free
qrx	taken
qrn	free
qry	taken
qrp	free
qrq	free
qrz	taken
qsa	taken
qrv	free
qrr	free
qrt	free
qru	free
qsc	free
qrw	free
qsb	free
qsd	free
qse	free
qsf	free
qsl	taken
qsm	taken
qsg	free
qsh	free
qsi	free
qst	taken
qsj	free
qsk	free
qsn	free
qso	free
qsp	free
qss	free
qsr	free
qtc	taken
qsq	free
qsv	free
qsu	free
qsw	free
qsx	free
qsz	free
qtb	free
qsy	free
qta	free
qth	free
qti	free
qtd	free
qtf	free
qte	free
qtk	free
qtg	free
qtj	free
qtm	free
qts	taken
qtl	free
qtq	free
qtr	free
qtp	free
qty	taken
qtv	free
qtw	free
qua	taken
qub	taken
qto	free
qtn	free
qtt	free
que	taken
qtu	free
qui	taken
quk	taken
qtz	free
quc	free
qtx	free
qun	taken
quo	taken
qup	taken
qud	free
qug	free
quf	free
quh	free
quu	taken
quj	free
quq	free
qux	taken
qum	free
qul	free
quw	free
qur	free
qus	free
qvc	taken
qut	free
qvd	taken
quv	free
qvb	free
quy	free
quz	free
qva	free
qvf	free
qvj	free
qvk	free
qve	free
qvg	free
qvh	free
qvi	free
qvl	free
qvm	free
qvp	free
qvn	free
qvr	free
qvo	free
qvs	free
qvx	taken
qvu	free
qvq	free
qvt	free
qwe	taken
qvv	free
qvy	free
qwb	free
qvw	free
qvz	free
qwa	free
qwf	free
qwg	free
qwc	free
qwh	free
qwd	free
qwi	free
qwn	taken
qws	taken
qwt	taken
qwj	free
qwl	free
qwo	free
qwp	free
qwx	taken
qwk	free
qwr	free
qwu	free
qwv	free
qwm	free
qwq	free
qxf	taken
qwy	free
qxc	free
qww	free
qxe	free
qxg	free
qwz	free
qxb	free
qxa	free
qxd	free
qxi	free
qxk	free
qxh	free
qxl	free
qxm	free
qxj	free
qxp	free
qxr	free
qxn	free
qxo	free
qxt	free
qxs	free
qxq	free
qxu	free
qxw	free
qxx	free
qxv	free
qyb	free
qxy	free
qxz	free
qyg	free
qya	free
qyc	free
qyd	free
qye	free
qyf	free
qyh	free
qyi	free
qyj	free
qyk	free
qyp	free
qyq	free
qyr	free
qys	free
qyl	free
qym	free
qyn	free
qyt	free
qyo	free
qyw	free
qyx	free
qyu	free
qza	free
qyv	free
qyy	free
qyz	free
qzd	free
qzb	free
qzf	free
qzg	free
qzc	free
qze	free
qzh	free
qzk	free
qzm	free
qzi	free
qzn	free
qzj	free
qzl	free
qzo	free
qzr	free
qzx	taken
qzp	free
qzy	taken
qzt	free
qzq	free
qzv	free
rab	taken
rac	taken
rad	taken
rae	taken
qzw	free
raf	taken
qzs	free
rag	taken
qzu	free
rai	taken
rah	taken
rak	taken
qzz	free
ral	taken
ram	taken
ran	taken
rap	taken
rar	taken
ras	taken
rat	taken
rav	taken
raw	taken
raa	free
rax	taken
ray	taken
rbb	taken
rbc	taken
raq	free
rbf	taken
rau	free
raj	free
rbi	taken
rao	free
rba	free
raz	free
rbd	free
rbj	free
rbk	free
rbe	free
rbl	free
rbn	taken
rbg	free
rbo	taken
rbp	taken
rbh	free
rbs	taken
rbt	taken
rbw	taken
rcb	taken
rbm	free
rcc	taken
rbu	free
rce	taken
rca	free
rcf	taken
rcg	taken
rbq	free
rbr	free
rbx	free
rby	free
rbv	free
rcl	taken
rbz	free
rcm	taken
rcp	taken
rcd	free
rcj	free
rck	free
rct	taken
rcn	free
rco	free
rcu	taken
rch	free
rci	free
rcs	free
rdb	taken
rdc	taken
rdd	taken
rcr	free
rcq	free
rcv	free
rcy	free
rdf	taken
rcx	free
rda	free
rdl	taken
rcw	free
rdm	taken
rcz	free
rdp	taken
rdh	free
rdk	free
rdr	taken
rde	free
rds	taken
rdg	free
rdi	free
rdj	free
rdq	free
rdx	taken
rdy	taken
rea	taken
reb	taken
rdn	free
rdo	free
rec	taken
rdv	free
red	taken
ree	taken
reg	taken
ref	taken
reh	taken
rei	taken
rej	taken
rdt	free
rek	taken
rel	taken
rem	taken
ren	taken
rdu	free
rdw	free
reo	taken
req	taken
rep	taken
rer	taken
res	taken
ret	taken
rev	taken
reu	taken
rex	taken
rey	taken
rez	taken
rew	taken
rfb	taken
rdz	free
rfc	taken
rfe	taken
rfm	taken
rff	free
rfi	free
rfg	free
rfk	free
rfo	taken
rfr	taken
rfa	free
rfj	free
rfd	free
rfh	free
rfl	free
rfx	taken
rfn	free
rfq	free
rgb	taken
rfv	free
rfw	free
rfp	free
rfs	free
rft	free
rga	free
rfu	free
rfy	free
rgc	free
rfz	free
rgd	free
rgf	free
rge	free
rgh	free
rgi	free
rgl	free
rgn	free
rgg	free
rgs	taken
rgp	free
rgj	free
rgu	taken
rgk	free
rgm	free
rgx	taken
rgo	free
rgq	free
rhc	taken
rgv	free
rgr	free
rgy	free
rgz	free
rhf	taken
rgt	free
rgw	free
rhd	free
rhe	free
rhb	free
rha	free
rhg	free
rhi	free
rho	taken
rhj	free
rhk	free
rhl	free
rhh	free
rhm	free
rhn	free
rhq	free
rhr	free
rhu	free
ria	taken
rib	taken
ric	taken
rhv	free
rhp	free
rhw	free
rid	taken
rhs	free
rht	free
rif	taken
rig	taken
rij	taken
rim	taken
rin	taken
rhy	free
rhx	free
rio	taken
rie	free
rip	taken
rhz	free
rii	free
rik	free
riv	taken
riw	taken
rix	taken
rih	free
riq	free
ril	free
ris	free
rjc	taken
rir	free
rit	free
riu	free
rjb	free
rjd	free
riy	free
riz	free
rja	free
rjn	taken
rje	free
rjh	free
rjj	free
rjf	free
rjg	free
rjs	taken
rji	free
rjt	taken
rjo	free
rjk	free
rjp	free
rjm	free
rjl	free
rkb	taken
rju	free
rjw	free
rjq	free
rjr	free
rjy	free
rjv	free
rjx	free
rkd	free
rjz	free
rka	free
rke	free
rkg	free
rkf	free
rkh	free
rkc	free
rki	free
rkj	free
rkk	free
rkl	free
rkt	taken
rkn	free
rkp	free
rks	free
rkm	free
rko	free
rkw	free
rkr	free
rkq	free
rkv	free
rky	free
rld	taken
rle	taken
rku	free
rkx	free
rlc	free
rkz	free
rlf	free
rla	free
rlh	free
rlb	free
rlp	taken
rlk	free
rlg	free
rli	free
rlj	free
rll	free
rls	taken
rlm	free
rlu	taken
rlx	taken
rly	taken
rln	free
rmb	taken
rlo	free
rlq	free
rmc	taken
rmd	taken
rme	taken
rlr	free
rmf	taken
rmg	taken
rmi	taken
rmk	taken
rlt	free
rml	taken
rlw	free
rlv	free
rlz	free
rmq	taken
rmr	taken
rma	free
rms	taken
rmt	taken
rmv	taken
rmj	free
rmm	free
rmx	taken
rmh	free
rna	taken
rnc	taken
rnd	taken
rmp	free
rmn	free
rmo	free
rne	taken
rmy	free
rng	taken
rnh	taken
rnb	free
rmu	free
rnm	taken
rmw	free
rmz	free
rnp	taken
rnr	taken
rni	free
rnj	free
rns	taken
rno	free
rnf	free
rnk	free
rnx	taken
rnl	free
rnt	free
rnn	free
rnu	free
rob	taken
roc	taken
rod	taken
rnq	free
roe	taken
roa	taken
rof	taken
rny	free
rog	taken
roi	taken
rnv	free
rok	taken
rnw	free
rom	taken
rol	taken
ron	taken
roo	taken
roq	taken
ror	taken
ros	taken
rot	taken
rou	taken
roh	free
rnz	free
row	taken
rox	taken
roy	taken
roz	taken
rpc	taken
rpd	taken
rpg	taken
rpi	taken
roj	free
rov	free
rpl	taken
rop	free
rpa	free
rpb	free
rpm	taken
rpe	free
rpf	free
rpn	taken
rph	free
rpq	taken
rpp	taken
rps	taken
rpj	free
rpt	taken
rpv	taken
rpx	taken
rpo	free
rpk	free
rpw	free
rpy	free
rqf	taken
rpr	free
rpu	free
rpz	free
rqa	free
rqe	free
rqb	free
rqc	free
rql	taken
rqg	free
rqd	free
rqi	free
rqj	free
rqr	taken
rqk	free
rqn	free
rqh	free
rqp	free
rqx	taken
rqm	free
rqq	free
rqo	free
rqt	free
rqu	free
rrb	taken
rrc	taken
rrd	taken
rqw	free
rrf	taken
rqs	free
rqv	free
rqz	free
rra	free
rrm	taken
rre	free
rqy	free
rrj	free
rrq	taken
rri	free
rrk	free
rrr	taken
rrs	taken
rrl	free
rrg	free
rrh	free
rrx	taken
rro	free
rsa	taken
rrn	free
rsc	taken
rru	free
rrw	free
rrv	free
rrp	free
rsd	taken
rry	free
rrz	free
rrt	free
rsh	taken
rsi	taken
rsj	taken
rsm	taken
rsp	taken
rse	free
rsr	taken
rsf	free
rsb	free
rss	taken
rsn	free
rst	taken
rsg	free
rsq	free
rsx	taken
rsz	taken
rsk	free
rta	taken
rsl	free
rtc	taken
rso	free
rte	taken
rtf	taken
rsw	free
rtg	taken
rtl	taken
rsu	free
rsv	free
rtd	free
rtm	taken
rsy	free
rto	taken
rti	free
rtp	taken
rtb	free
rtr	taken
rts	taken
rtt	taken
rtj	free
rth	free
rtx	taken
rty	taken
rtn	free
rtk	free
rtq	free
rua	taken
rub	taken
rue	taken
ruf	taken
rtv	free
rug	taken
rtw	free
rui	taken
ruk	taken
rul	taken
rum	taken
run	taken
ruo	taken
rtu	free
rup	taken
rur	taken
rut	taken
ruj	free
rtz	free
ruc	free
rud	free
rux	taken
ruh	free
rva	taken
ruq	free
rvc	taken
rvb	free
rus	free
ruu	free
ruv	free
rvd	free
rvi	taken
ruw	free
ruy	free
ruz	free
rvm	taken
rve	free
rvf	free
rvg	free
rvh	free
rvj	free
rvl	free
rvn	free
rvp	free
rvk	free
rvq	free
rvt	free
rvs	free
rvo	free
rwb	taken
rwc	taken
rvr	free
rwd	taken
rvu	free
rvv	free
rvw	free
rwi	taken
rvy	free
rvx	free
rvz	free
rwe	free
rwf	free
rwg	free
rwa	free
rwj	free
rwk	free
rwh	free
rws	taken
rwt	taken
rwo	free
rwq	free
rwm	free
rwl	free
rwp	free
rwn	free
rwr	free
rwu	free
rxc	taken
rwv	free
rww	free
rwz	free
rxa	free
rwx	free
rxe	free
rxd	free
rwy	free
rxg	free
rxb	free
rxn	taken
rxq	taken
rxf	free
rxj	free
rxh	free
rxr	taken
rxl	free
rxs	taken
rxt	taken
rxu	taken
rxi	free
rxy	taken
rxk	free
rya	taken
rxm	free
rxo	free
rxp	free
rxw	free
rye	taken
rxx	free
ryb	free
rxv	free
rxz	free
ryf	free
ryi	free
ryc	free
ryj	free
ryo	taken
ryd	free
ryg	free
ryh	free
rym	free
ryu	taken
ryn	free
ryk	free
ryl	free
ryz	taken
ryt	free
ryp	free
ryq	free
ryv	free
ryw	free
ryr	free
rys	free
ryx	free
ryy	free
rza	free
rzc	free
rze	free
rzh	free
rzi	free
rzj	free
rzb	free
rzd	free
rzk	free
rzf	free
rzg	free
rzr	taken
rzv	taken
rzm	free
rzl	free
rzt	free
rzn	free
rzo	free
rzp	free
rzq	free
saa	taken
rzw	free
rzx	free
sac	taken
rzs	free
sad	taken
rzu	free
sae	taken
sag	taken
sai	taken
sak	taken
sal	taken
sam	taken
san	taken
sao	taken
sap	taken
rzz	free
sar	taken
sab	free
rzy	free
sas	taken
sat	taken
sah	free
saf	free
sav	taken
saw	taken
sax	taken
say	taken
saz	taken
sbc	taken
sbd	taken
sbe	taken
saj	free
saq	free
sba	free
sau	free
sbb	free
sbm	taken
sbn	taken
sbg	free
sbk	free
sbj	free
sbf	free
sbs	taken
sbi	free
sbt	taken
sbh	free
sbu	taken
sbx	taken
sbo	free
sbp	free
sca	taken
scb	taken
sbl	free
scc	taken
sby	free
sbr	free
sbz	free
sbq	free
sch	taken
scj	taken
sci	taken
sbv	free
sbw	free
scm	taken
scn	taken
sco	taken
scf	free
scp	taken
scs	taken
scd	free
sce	free
sct	taken
scg	free
scv	taken
scx	taken
sdb	taken
scl	free
sck	free
sdc	taken
sdd	taken
scy	free
scq	free
scz	free
sdf	taken
scr	free
sda	free
sdi	taken
scu	free
sdk	taken
sdl	taken
sdm	taken
scw	free
sde	free
sdp	taken
sdr	taken
sdt	taken
sds	taken
sdh	free
sdj	free
sdv	taken
sdw	taken
sdx	taken
sdg	free
sea	taken
sdo	free
seb	taken
sec	taken
sdn	free
sdq	free
sdu	free
sef	taken
see	taken
sek	taken
sel	taken
sem	taken
sen	taken
seo	taken
sep	taken
seq	taken
sej	free
ser	taken
ses	taken
sdy	free
sdz	free
sei	free
set	taken
seu	taken
sev	taken
sew	taken
sex	taken
sey	taken
sed	free
sfc	taken
seh	free
sfe	taken
seg	free
sfg	taken
sfl	taken
sfm	taken
sfa	free
sff	free
sfh	free
sfj	free
sfp	taken
sez	free
sfb	free
sfd	free
sfs	taken
sft	taken
sfi	free
sfn	free
sfk	free
sfx	taken
sfr	free
sfo	free
sfv	free
sgc	taken
sfw	free
sfq	free
sgf	taken
sgb	free
sgh	taken
sfu	free
sfy	free
sfz	free
sgd	free
sga	free
sgm	taken
sgg	free
sgp	taken
sgr	taken
sgj	free
sge	free
sgi	free
sgq	free
sgl	free
sgk	free
sgw	taken
sha	taken
sgn	free
sgt	free
sgo	free
sgv	free
shc	taken
shd	taken
sgs	free
she	taken
shh	taken
shi	taken
sgy	free
sgu	free
shm	taken
sho	taken
shg	free
sgz	free
sgx	free
shp	taken
shs	taken
shk	free
shb	free
shf	free
shu	taken
shj	free
shx	taken
shy	taken
shl	free
shr	free
sia	taken
shn	free
sic	taken
sid	taken
sie	taken
shv	free
sif	taken
sig	taken
sii	taken
shq	free
sik	taken
sht	free
sim	taken
sin	taken
sib	free
shw	free
sio	taken
siq	taken
sip	taken
sis	taken
sit	taken
siu	taken
shz	free
sir	taken
sij	free
sih	free
siv	taken
sil	free
six	taken
siw	free
siz	free
sje	free
sjg	free
sjf	free
siy	free
sja	free
sjb	free
sjd	free
sjc	free
sji	taken
sjl	taken
sjp	taken
sjs	taken
sjj	free
sjn	free
sjo	free
sjq	free
sjv	taken
sjr	free
sjw	taken
sjt	free
ska	taken
sjh	free
sjk	free
sju	free
skb	taken
sjm	free
ski	taken
sjx	free
sjy	free
skk	taken
skl	taken
ske	free
skm	taken
skh	free
sko	taken
sjz	free
skp	taken
skc	free
skg	free
skf	free
skt	taken
skd	free
sku	taken
skv	taken
sky	taken
skj	free
sla	taken
skq	free
slb	taken
slc	taken
sks	free
slf	taken
slg	taken
skn	free
skx	free
skr	free
slj	taken
slk	taken
slm	taken
sln	taken
sle	free
skw	free
skz	free
slp	taken
slh	free
slq	taken
slr	taken
sls	taken
sld	free
slt	taken
slu	taken
slv	taken
slo	free
sly	taken
sma	taken
sli	free
smc	taken
smd	taken
sme	taken
sll	free
smf	taken
smg	taken
slw	free
smh	taken
slz	free
smi	taken
sml	taken
smb	free
smm	taken
smn	taken
smp	taken
smq	taken
smr	taken
slx	free
smt	taken
smu	taken
sms	taken
smk	free
snc	taken
smv	free
smj	free
smx	free
snd	taken
smz	free
snb	free
smo	free
sng	taken
sni	taken
snk	taken
smw	free
sna	free
smy	free
sne	free
snp	taken
snr	taken
sns	taken
snl	free
snu	taken
snf	free
sno	free
snh	free
snj	free
snq	free
snx	taken
snm	free
soa	taken
snn	free
sob	taken
soc	taken
sod	taken
sof	taken
soh	taken
snw	free
soi	taken
sny	free
snt	free
snz	free
sol	taken
snv	free
som	taken
son	taken
soo	taken
sop	taken
soe	free
soq	taken
sog	free
sor	taken
sos	taken
sou	taken
sox	taken
sow	taken
soy	taken
spa	taken
spb	taken
spc	taken
spd	taken
spe	taken
spf	taken
soj	free
spg	taken
sph	taken
spi	taken
sot	free
sok	free
spm	taken
spn	taken
spo	taken
spp	taken
spr	taken
sps	taken
spt	taken
sov	free
spv	taken
soz	free
spw	taken
spx	taken
spy	taken
spz	taken
spq	free
sqd	taken
spj	free
spk	free
spl	free
sqa	free
sqc	free
spu	free
sqe	free
sqf	free
sqg	free
sql	taken
sqn	taken
sqh	free
sqj	free
sqr	taken
sqb	free
sqs	taken
sqt	taken
sqi	free
sqk	free
sqm	free
sqo	free
sra	taken
sqx	free
sqp	free
sqq	free
srb	taken
src	taken
sre	taken
sqv	free
squ	free
sqw	free
sri	taken
sqy	free
srl	taken
srm	taken
srd	free
sro	taken
srp	taken
srh	free
srg	free
sqz	free
srq	taken
srs	taken
srj	free
srk	free
srt	taken
sru	taken
srv	taken
srn	free
srw	taken
srf	free
ssa	taken
ssb	taken
ssc	taken
sse	taken
ssd	taken
ssf	taken
ssg	taken
ssh	taken
srr	free
ssi	taken
ssl	taken
ssm	taken
ssn	taken
sry	free
sso	taken
ssp	taken
ssq	taken
ssr	taken
sss	taken
sst	taken
ssv	taken
ssz	taken
srx	free
sta	taken
srz	free
stc	taken
stb	taken
std	taken
ssj	free
stf	taken
ssu	free
stg	taken
ssk	free
ssx	free
ssy	free
sti	taken
stj	taken
stk	taken
stl	taken
stm	taken
stn	taken
stp	taken
str	taken
ssw	free
sts	taken
stt	taken
stu	taken
sth	free
sty	taken
sua	taken
sub	taken
ste	free
sud	taken
sue	taken
stq	free
stx	free
sug	taken
suh	taken
sui	taken
sto	free
suc	free
sum	taken
stv	free
sun	taken
sup	taken
stw	free
stz	free
suq	taken
sur	taken
sus	taken
sut	taken
suu	taken
suv	taken
suk	free
sux	taken
suf	free
svb	taken
svc	taken
sul	free
suj	free
suo	free
suy	free
svg	taken
suz	free
sva	free
svh	taken
svd	free
svl	taken
svm	taken
svn	taken
sve	free
suw	free
svf	free
svp	taken
svs	taken
svj	free
svq	free
svi	free
svu	free
svt	free
svk	free
swa	taken
svo	free
swc	taken
svx	free
svr	free
swe	taken
swf	taken
svw	free
svv	free
swg	taken
swh	taken
swb	free
swm	taken
swn	taken
swd	free
swp	taken
svy	free
svz	free
sws	taken
swk	free
swt	taken
swi	free
swj	free
swl	free
swq	free
swo	free
swx	free
swr	free
swu	free
swv	free
sww	free
sxb	free
swy	free
sxe	free
swz	free
sxa	free
sxf	free
sxc	free
sxg	free
sxd	free
sxh	free
sxi	free
sxl	free
sxo	free
sxp	free
sxk	free
sxr	free
sxj	free
sxm	free
sxs	free
sxy	taken
sxn	free
sxq	free
syc	taken
sxv	free
sxw	free
sxt	free
sxz	free
syg	taken
sya	free
sxu	free
sxx	free
syd	free
syl	taken
sym	taken
syn	taken
syb	free
syo	taken
syi	free
syh	free
syp	taken
sye	free
syj	free
sys	taken
syk	free
syf	free
syq	free
syt	free
syu	free
syv	free
syw	free
syz	free
szc	taken
syr	free
sza	free
syy	free
syx	free
sze	free
szd	free
szi	free
szb	free
szk	free
szf	free
szg	free
szh	free
szj	free
szo	free
szl	free
szp	free
szm	free
szn	free
szq	free
szr	free
szy	taken
szs	free
szu	free
tab	taken
tac	taken
tad	taken
szv	free
tag	taken
szt	free
tai	taken
szz	free
tak	taken
tal	taken
szw	free
szx	free
tae	free
tam	taken
tan	taken
tao	taken
tap	taken
tar	taken
tas	taken
tat	taken
taa	free
tau	taken
tav	taken
tax	taken
taz	taken
taf	free
tba	taken
tah	free
tbd	taken
taj	free
taw	free
tay	free
tbb	free
taq	free
tbf	free
tbh	free
tbn	taken
tbc	free
tbj	free
tbe	free
tbk	free
tbq	taken
tbg	free
tbl	free
tbi	free
tbm	free
tbs	taken
tbt	taken
tbw	taken
tbx	taken
tca	taken
tbp	free
tcc	taken
tbo	free
tbv	free
tbu	free
tby	free
tcg	taken
tbr	free
tch	taken
tcl	taken
tcm	taken
tbz	free
tcn	taken
tco	taken
tcb	free
tcp	taken
tcd	free
tce	free
tcf	free
tck	free
tcx	taken
tci	free
tcj	free
tcr	free
tcu	free
tcv	free
tda	taken
tdb	taken
tcq	free
tcs	free
tct	free
tdd	taken
tdf	taken
tdg	taken
tcw	free
tcz	free
tdi	taken
tdm	taken
tcy	free
tdp	taken
tde	free
tdh	free
tdc	free
tdr	taken
tds	taken
tdn	free
tdw	taken
tdo	free
tdj	free
tdl	free
tdk	free
tea	taken
tdt	free
tec	taken
ted	taken
tdq	free
tee	taken
tef	taken
tdy	free
teg	taken
tdv	free
tdu	free
tdx	free
tdz	free
tek	taken
tel	taken
tem	taken
teb	free
tei	free
ten	taken
teo	taken
teq	taken
tej	free
tes	taken
tet	taken
tex	taken
tez	taken
tfa	taken
teh	free
tep	free
tfe	taken
tew	free
tey	free
ter	free
tfc	free
tfi	taken
teu	free
tfd	free
tev	free
tfl	taken
tfm	taken
tfn	taken
tfb	free
tfh	free
tfs	taken
tfj	free
tff	free
tfg	free
tft	taken
tfo	free
tfp	free
tfu	taken
tfx	taken
tfy	taken
tga	taken
tfk	free
tgd	taken
tgf	taken
tfq	free
tfr	free
tfw	free
tfv	free
tgi	taken
tfz	free
tgc	free
tge	free
tgb	free
tgm	free
tgn	free
tgg	free
tgr	taken
tgh	free
tgj	free
tgk	free
tgp	free
tgt	taken
tgl	free
tgz	taken
tgq	free
tgo	free
thc	taken
tgu	free
the	taken
tgv	free
tgx	free
tgw	free
tgy	free
tgs	free
thb	free
thm	taken
tha	free
thf	free
thg	free
tho	taken
thd	free
thi	free
thr	taken
ths	taken
thu	taken
thh	free
thk	free
thj	free
thw	taken
thl	free
thx	taken
thy	taken
thq	free
tia	taken
tic	taken
thn	free
tie	taken
tid	taken
thv	free
tif	taken
tig	taken
thp	free
tht	free
tii	taken
tik	taken
til	taken
tim	taken
tin	taken
tio	taken
tip	taken
tiq	taken
tir	taken
tis	taken
tit	taken
thz	free
tix	taken
tih	free
tiz	taken
tib	free
tjc	taken
tiv	free
tiw	free
tij	free
tja	free
tiu	free
tiy	free
tjb	free
tje	free
tjd	free
tjj	free
tjf	free
tjq	taken
tjg	free
tji	free
tjh	free
tjl	free
tjs	taken
tjn	free
tjo	free
tjk	free
tjp	free
tjm	free
tjw	free
tjv	free
tjy	free
tjr	free
tjt	free
tka	free
tju	free
tkb	free
tjx	free
tjz	free
tkh	free
tkc	free
tkd	free
tkk	free
tkn	taken
tke	free
tko	taken
tkf	free
tkg	free
tki	free
tks	taken
tkt	taken
tkj	free
tkl	free
tkp	free
tkq	free
tkm	free
tku	free
tkw	free
tkx	free
tky	free
tlc	taken
tld	taken
tkr	free
tle	taken
tli	taken
tkv	free
tlb	free
tkz	free
tla	free
tlj	free
tlk	free
tll	free
tlr	taken
tlg	free
tlh	free
tlf	free
tls	taken
tlo	free
tlt	taken
tlv	taken
tly	taken
tlm	free
tlp	free
tln	free
tmc	taken
tmd	taken
tmg	taken
tlq	free
tlx	free
tlz	free
tma	free
tmi	taken
tmb	free
tlw	free
tlu	free
tml	taken
tme	free
tmm	taken
tmp	taken
tmr	taken
tms	taken
tmt	taken
tmh	free
tmf	free
tmx	taken
tmj	free
tmk	free
tmu	free
tmv	free
tmw	free
tmo	free
tmn	free
tmq	free
tmz	free
tng	taken
tni	taken
tna	free
tnb	free
tnl	taken
tmy	free
tne	free
tnf	free
tnh	free
tnc	free
tnr	taken
tnd	free
tns	taken
tnt	taken
tnj	free
tnp	free
tnk	free
tny	taken
tnm	free
tnn	free
tno	free
toa	taken
tob	taken
tnq	free
tnv	free
toc	taken
tnw	free
tod	taken
toe	taken
tof	taken
tnx	free
tog	taken
toi	taken
tnu	free
tok	taken
tom	taken
ton	taken
too	taken
top	taken
toq	taken
tor	taken
tot	taken
tou	taken
tos	taken
tow	taken
tox	taken
tnz	free
toh	free
toy	taken
tpb	taken
tol	free
tpd	taken
tpi	taken
toj	free
toz	free
tpl	taken
tpf	free
tpe	free
tpg	free
tov	free
tph	free
tpm	taken
tpa	free
tpp	taken
tpr	taken
tpj	free
tps	taken
tpc	free
tpt	taken
tpy	taken
tpz	taken
tpn	free
tpk	free
tpo	free
tpu	free
tpw	free
tpx	free
tpq	free
tqc	free
tpv	free
tqa	free
tqf	free
tqb	free
tqg	free
tql	taken
tqe	free
tqd	free
tqj	free
tqk	free
tqq	taken
tqh	free
tqi	free
tqm	free
tqn	free
tqo	free
tqp	free
tra	taken
tqr	free
tqs	free
tqt	free
trb	taken
trc	taken
tqx	free
tqz	free
tqu	free
tri	taken
tqv	free
tqw	free
tre	free
trf	free
trk	taken
trl	taken
trm	taken
trn	taken
trh	free
tqy	free
trs	taken
trd	free
trg	free
tru	taken
try	taken
trp	free
trj	free
tsa	taken
trt	free
tsb	taken
trv	free
tsc	taken
tsd	taken
tro	free
tse	taken
trq	free
trr	free
tsf	taken
tsg	taken
tsh	taken
tsi	taken
trz	free
trw	free
tsl	taken
tsm	taken
trx	free
tsk	taken
tsp	taken
tsn	taken
tso	taken
tsr	taken
tss	taken
tst	taken
tsu	taken
tsv	taken
tsw	taken
tsx	taken
tsz	taken
tsq	free
tsj	free
ttb	free
ttf	free
ttg	free
tsy	free
tth	free
ttk	taken
ttl	taken
tta	free
ttc	free
tti	free
ttm	taken
tte	free
ttn	taken
ttd	free
ttp	taken
ttq	taken
ttr	taken
ttj	free
ttt	taken
tts	taken
tty	taken
ttx	taken
tub	taken
tuc	taken
tto	free
tuf	taken
tug	taken
tui	taken
ttu	free
ttw	free
ttv	free
tua	free
tul	taken
tud	free
tue	free
tun	taken
tuo	taken
tup	taken
tus	taken
tuh	free
ttz	free
tut	taken
tuu	taken
tuj	free
tuk	free
tux	taken
tum	free
tuq	free
tuv	free
tuy	free
tuw	free
tuz	free
tva	free
tur	free
tvc	free
tvb	free
tvm	taken
tvd	free
tvf	free
tve	free
tvi	free
tvr	taken
tvn	free
tvg	free
tvh	free
tvj	free
tvk	free
tvl	free
tvp	free
tvq	free
tvo	free
tvx	free
twb	taken
tvy	free
tvs	free
tvz	free
twc	taken
twa	free
tvt	free
tvu	free
tvv	free
tvw	free
twh	taken
twi	taken
twl	taken
two	taken
twp	taken
twd	free
twe	free
twq	taken
twf	free
tws	taken
twt	taken
twm	free
twn	free
twu	taken
twx	taken
twg	free
twj	free
twk	free
tww	free
twr	free
twz	free
twy	free
txf	taken
txb	free
txa	free
txc	free
twv	free
txd	free
txe	free
txn	taken
txg	free
txi	free
txk	free
txl	free
txm	free
txs	taken
txo	free
txt	taken
txh	free
txj	free
txp	free
txq	free
txu	free
txv	free
txx	free
txy	free
tyd	taken
tye	taken
txr	free
txz	free
tya	free
tyg	taken
txw	free
tyk	taken
tyl	taken
tym	taken
tyb	free
tyo	taken
typ	taken
tyr	taken
tyf	free
tyh	free
tyi	free
tyj	free
tyc	free
tyq	free
tyt	free
tys	free
tyn	free
tyu	free
tyw	free
tyx	free
tyy	free
tyz	free
tyv	free
tza	free
tzc	free
tzg	free
tzb	free
tzi	free
tzd	free
tzj	free
tzk	free
tze	free
tzf	free
tzh	free
tzu	taken
tzo	free
tzl	free
tzq	free
tzs	free
tzm	free
tzn	free
tzp	free
tzr	free
tzt	free
uac	taken
uad	taken
tzy	free
uae	taken
tzv	free
tzw	free
uab	free
tzx	free
tzz	free
uam	taken
uaa	free
uan	taken
uai	free
uaj	free
uap	taken
uak	free
ual	free
uaf	free
uag	free
uah	free
uav	taken
uar	free
uao	free
uau	free
uaw	free
uaq	free
uba	taken
uay	free
uas	free
uaz	free
uat	free
uax	free
ubf	taken
ubk	taken
ubm	taken
ubd	free
ube	free
ubj	free
ubh	free
ubg	free
ubi	free
ubl	free
ubc	free
ubb	free
ubs	taken
ubn	free
ubp	free
ubt	free
ubr	free
ubu	free
ubo	free
ubw	free
ucb	taken
ucc	taken
ucd	taken
ubq	free
uch	taken
uci	taken
ubx	free
ubz	free
ubv	free
uca	free
ucl	taken
uby	free
ucg	free
ucj	free
ucm	free
uco	free
uce	free
ucf	free
ucn	free
uck	free
ucu	free
ucq	free
ucp	free
ucr	free
udb	taken
udc	taken
ucy	free
ucs	free
uct	free
ucw	free
ucv	free
ucx	free
ucz	free
uda	free
udm	taken
udd	free
udf	free
udg	free
udh	free
udo	taken
udj	free
udp	taken
udt	taken
ude	free
udi	free
udk	free
udl	free
udr	free
uds	free
udu	free
udn	free
udw	free
ueb	taken
udq	free
ued	taken
udx	free
udv	free
udz	free
udy	free
uek	taken
uef	free
uee	free
ueh	free
uea	free
uei	free
uec	free
ueg	free
uet	taken
ueo	free
uej	free
uel	free
uep	free
ueq	free
ues	free
uem	free
uen	free
uer	free
ufc	taken
ueu	free
ufa	free
uew	free
uev	free
uex	free
uey	free
uez	free
ufd	free
ufb	free
ufe	free
uff	free
ufo	taken
ufi	free
ufp	taken
ufl	free
ufk	free
ufm	free
ufg	free
ufr	taken
ufs	taken
ufh	free
ufj	free
ufn	free
ufq	free
ufu	free
ufx	free
ufw	free
ugc	taken
ufy	free
ufz	free
ugh	taken
uga	free
uft	free
ufv	free
ugd	free
ugf	free
ugb	free
ugi	free
ugo	taken
ugk	free
uge	free
ugg	free
ugm	free
ugj	free
ugn	free
ugl	free
ugq	free
ugr	free
ugs	free
ugt	free
ugu	free
ugv	free
ugp	free
uhf	taken
uha	free
uhc	free
ugw	free
uhd	free
uhe	free
ugy	free
uhh	taken
ugz	free
uhb	free
uhg	free
ugx	free
uhi	free
uhj	free
uhl	free
uhk	free
uhm	free
uhu	taken
uhq	free
uho	free
uhp	free
uhn	free
uhr	free
uhs	free
uic	taken
uhy	free
uid	taken
uhz	free
uia	free
uht	free
uib	free
uhw	free
uil	taken
uhv	free
uhx	free
uie	free
uio	taken
uig	free
uih	free
uij	free
uik	free
uis	taken
uim	free
uiv	taken
uii	free
uif	free
uip	free
uir	free
uix	taken
uit	free
uin	free
uiq	free
uiu	free
uja	free
ujc	free
ujf	free
uiw	free
uiy	free
uiz	free
ujb	free
ujg	free
uje	free
uji	free
ujd	free
ujh	free
ujs	taken
ujq	free
ujr	free
ujj	free
ujl	free
ujm	free
ujn	free
ujk	free
ujo	free
ujp	free
ukb	taken
ujx	free
ujz	free
ujy	free
ujt	free
uke	taken
ukc	free
uju	free
ukf	taken
ujv	free
ukd	free
ujw	free
uka	free
ukg	free
ukh	free
ukm	free
uko	free
uki	free
ukp	free
ukj	free
uku	taken
ukk	free
ukl	free
ukq	free
ukr	free
ukn	free
ukw	free
ukx	free
uky	free
ukt	free
uks	free
ukz	free
ula	free
ukv	free
ulb	free
ulc	free
ulg	free
ulf	free
ulh	free
uli	free
ulk	free
ulp	taken
ule	free
uld	free
ult	taken
ull	free
ulo	free
ulm	free
ulj	free
uls	free
uma	taken
ulq	free
ulr	free
uln	free
umc	taken
ulx	free
umd	taken
ume	taken
ulu	free
umf	taken
ulv	free
umi	taken
ulw	free
umm	taken
umn	taken
uly	free
ulz	free
umo	taken
ump	taken
umb	free
ums	taken
umk	free
uml	free
umh	free
umg	free
umj	free
umt	free
una	taken
umy	free
umz	free
umq	free
umu	free
umv	free
umw	free
unb	free
unc	free
umr	free
umx	free
ung	taken
uni	taken
uno	taken
unf	free
unh	free
und	free
une	free
unk	free
unm	free
unq	taken
unt	taken
unv	taken
unu	taken
unj	free
unp	free
unl	free
unn	free
unr	free
uny	free
unz	free
uob	free
uns	free
uoc	free
unw	free
unx	free
uok	taken
uoa	free
uoe	free
uod	free
uof	free
uog	free
uom	free
uoh	free
uoi	free
uoj	free
uoq	free
uol	free
uor	free
uon	free
uoo	free
uow	taken
uop	free
uos	free
uot	free
upa	taken
uou	free
upb	taken
uov	free
upc	taken
upd	taken
upi	taken
uox	free
upm	taken
uoz	free
upg	free
uph	free
uoy	free
upj	free
upk	free
upl	free
upp	taken
ups	taken
upt	taken
upe	free
upf	free
upy	taken
upn	free
upu	free
upo	free
upx	free
upq	free
upr	free
upz	free
upv	free
uqa	free
upw	free
uqc	free
uqd	free
uqb	free
uqh	free
uql	taken
uqg	free
uqe	free
uqf	free
uqk	free
uqi	free
uqj	free
uqp	free
uqs	taken
uqq	free
uqo	free
uqm	free
uqn	free
ura	taken
uqu	free
uqr	free
uqx	free
uqy	free
uqz	free
uqt	free
uqv	free
uqw	free
uri	taken
urc	free
urj	taken
url	taken
urd	free
urb	free
urn	taken
urf	free
urg	free
urt	taken
ure	free
uru	taken
urh	free
uro	free
urk	free
urs	free
urm	free
usa	taken
usb	taken
urp	free
urv	free
urq	free
usd	taken
use	taken
urr	free
ury	free
ush	taken
urw	free
urx	free
usf	free
urz	free
usj	free
usi	free
usk	free
usc	free
uso	taken
usl	free
usp	taken
usr	taken
ust	taken
usn	free
usg	free
usx	taken
uta	taken
usm	free
usq	free
uss	free
utc	taken
usv	free
ute	taken
utf	taken
usy	free
uti	taken
usu	free
usw	free
utl	taken
usz	free
utm	taken
utg	free
uto	taken
uth	free
utp	taken
utb	free
utd	free
utj	free
uts	taken
utu	taken
utk	free
utr	free
utv	free
utn	free
utw	free
uty	free
utq	free
uue	taken
utt	free
utx	free
uui	taken
utz	free
uuc	free
uud	free
uuf	free
uua	free
uub	free
uup	taken
uuj	free
uuk	free
uug	free
uuh	free
uum	free
uuu	taken
uuo	free
uuq	free
uul	free
uun	free
uus	free
uva	taken
uur	free
uuy	free
uuz	free
uut	free
uuv	free
uuw	free
uvb	free
uux	free
uvd	free
uvm	taken
uvc	free
uvg	free
uvh	free
uve	free
uvf	free
uvs	taken
uvj	free
uvi	free
uvk	free
uvo	free
uvl	free
uvp	free
uvn	free
uvr	free
uvq	free
uvv	free
uvu	free
uvw	free
uvy	free
uwa	free
uvt	free
uwb	free
uvx	free
uwc	free
uwd	free
uwe	free
uvz	free
uwg	free
uwh	free
uwi	free
uwp	taken
uwk	free
uws	taken
uwl	free
uwt	taken
uwm	free
uwn	free
uwf	free
uwj	free
uwq	free
uwo	free
uwu	free
uww	free
uwr	free
uwv	free
uxa	free
uwz	free
uwx	free
uwy	free
uxb	free
uxf	free
uxc	free
uxd	free
uxg	free
uxe	free
uxj	free
uxh	free
uxm	free
uxn	free
uxk	free
uxi	free
uxl	free
uxq	free
uxs	free
uxo	free
uxp	free
uxt	free
uxr	free
uxu	free
uxy	free
uxz	free
uya	free
uxv	free
uxw	free
uxx	free
uye	free
uyc	free
uyb	free
uyg	free
uyd	free
uyh	free
uyj	free
uyf	free
uyi	free
uym	free
uyk	free
uyo	free
uyq	free
uyr	free
uys	free
uyn	free
uyp	free
uyl	free
uyw	free
uyy	free
uyt	free
uyz	free
uyx	free
uyv	free
uyu	free
uzd	free
uza	free
uze	free
uzi	taken
uzf	free
uzb	free
uzc	free
uzo	taken
uzh	free
uzg	free
uzm	free
uzq	free
uzj	free
uzk	free
uzl	free
uzn	free
uzp	free
uzr	free
uzu	free
uzv	free
uzs	free
uzt	free
vac	taken
vad	taken
vaf	taken
uzw	free
uzx	free
uzy	free
uzz	free
vaa	free
vag	free
val	taken
vab	free
vam	taken
vai	free
van	taken
var	taken
vaq	taken
vae	free
vas	taken
vat	taken
vah	free
vaj	free
vax	taken
vbb	taken
vbc	taken
vak	free
vav	free
vay	free
vao	free
vbd	taken
vap	free
vau	free
vaw	free
vaz	free
vba	free
vbe	free
vbg	free
vbh	free
vbi	free
vbj	free
vbk	free
vbf	free
vbm	free
vbn	free
vbo	free
vbp	free
vbr	free
vbs	free
vbl	free
vbu	free
vbv	free
vbq	free
vcc	taken
vbw	free
vcd	taken
vbt	free
vbx	free
vcf	taken
vch	taken
vcl	taken
vby	free
vcm	taken
vbz	free
vca	free
vcn	taken
vcb	free
vck	free
vcr	taken
vce	free
vcs	taken
vct	taken
vcg	free
vcj	free
vci	free
vco	free
vcp	free
vdb	taken
vdc	taken
vcu	free
vcw	free
vcx	free
vdf	taken
vcq	free
vcz	free
vcv	free
vcy	free
vda	free
vdg	free
vdi	free
vdm	taken
vdd	free
vdj	free
vdo	taken
vdk	free
vde	free
vdp	taken
vdr	taken
vds	taken
vdt	taken
vdh	free
vdl	free
veb	taken
vdn	free
vec	taken
vdq	free
ved	taken
vee	taken
vdy	free
veg	taken
vej	taken
vdw	free
vdv	free
vdu	free
vdx	free
vdz	free
vea	free
vel	taken
veo	taken
veh	free
vei	free
ver	taken
vek	free
vef	free
vet	taken
vex	taken
vem	free
vep	free
vez	taken
vfc	taken
ven	free
veq	free
vfe	taken
ves	free
veu	free
vev	free
vew	free
vey	free
vfd	free
vfa	free
vfb	free
vfi	free
vff	free
vfj	free
vfl	free
vfg	free
vfq	taken
vfh	free
vfn	free
vfs	taken
vfo	free
vfk	free
vfw	taken
vfx	taken
vfm	free
vfp	free
vgc	taken
vfr	free
vgd	taken
vfu	free
vfv	free
vfy	free
vfz	free
vft	free
vgj	taken
vgl	taken
vgm	taken
vgg	free
vga	free
vgb	free
vgo	taken
vgk	free
vge	free
vgf	free
vgi	free
vgh	free
vgn	free
vgq	free
vgt	free
vgp	free
vgr	free
vgw	free
vgs	free
vgy	free
vhd	taken
vgu	free
vgz	free
vgv	free
vgx	free
vha	free
vhc	free
vhg	free
vhi	free
vhb	free
vhj	free
vhe	free
vhl	free
vhp	taken
vhf	free
vhh	free
vhs	taken
vhm	free
vhk	free
vhx	taken
vhn	free
vho	free
via	taken
vic	taken
vhw	free
vid	taken
vie	taken
vhq	free
vht	free
vhr	free
vig	taken
vhv	free
vii	taken
vhz	free
vil	taken
vik	taken
vim	taken
vib	free
vin	taken
vio	taken
vip	taken
vir	taken
vis	taken
vit	taken
vhu	free
vhy	free
viu	taken
vix	taken
vif	free
viz	taken
vih	free
viy	free
vij	free
vja	free
viq	free
vjd	free
viv	free
viw	free
vjb	free
vjc	free
vje	free
vji	free
vjj	free
vjk	free
vjg	free
vjl	free
vjm	free
vjf	free
vjh	free
vjs	taken
vjv	taken
vjp	free
vjn	free
vjo	free
vka	taken
vju	free
vjx	free
vjq	free
vjw	free
vjy	free
vjr	free
vkg	taken
vjt	free
vkh	free
vkk	taken
vkc	free
vjz	free
vkj	free
vkd	free
vkf	free
vke	free
vki	free
vkb	free
vkq	free
vkl	free
vko	free
vkm	free
vku	free
vkn	free
vkp	free
vkv	free
vkr	free
vks	free
vla	taken
vkw	free
vkt	free
vlc	taken
vld	taken
vkx	free
vkz	free
vlf	free
vlh	free
vli	free
vky	free
vlk	free
vlb	free
vlq	taken
vle	free
vlg	free
vlj	free
vls	taken
vll	free
vlm	free
vlo	free
vlt	free
vlp	free
vln	free
vlw	free
vlx	free
vlr	free
vmc	taken
vly	free
vmd	taken
vme	taken
vlu	free
vlv	free
vmg	free
vlz	free
vma	free
vmm	taken
vmb	free
vmh	free
vmj	free
vml	free
vmf	free
vmn	free
vmo	free
vmi	free
vmk	free
vmp	free
vmv	taken
vmx	taken
vmt	free
vmq	free
vmu	free
vna	free
vnc	taken
vmr	free
vmw	free
vms	free
vmy	free
vnf	taken
vng	taken
vmz	free
vne	free
vnb	free
vnh	free
vni	free
vnm	free
vnd	free
vnt	taken
vnk	free
vnj	free
vnl	free
vnn	free
vnp	free
vnq	free
voa	taken
vno	free
voc	taken
vnv	free
vnr	free
vnw	free
vnx	free
vnu	free
vns	free
voi	taken
vob	free
vny	free
vok	taken
vol	taken
vnz	free
vod	free
vof	free
vom	taken
von	taken
voj	free
voo	taken
vor	taken
voe	free
vos	taken
vog	free
vow	taken
voh	free
vox	taken
voq	free
vpc	taken
vot	free
vou	free
vop	free
voz	free
vpf	taken
vpb	free
vpi	taken
vov	free
vpk	taken
vpl	taken
vpm	taken
voy	free
vpa	free
vpn	taken
vpg	free
vph	free
vpo	taken
vpp	taken
vpd	free
vps	taken
vpj	free
vpe	free
vpt	free
vpq	free
vqb	taken
vpu	free
vpw	free
vpx	free
vpz	free
vqa	free
vpr	free
vpv	free
vpy	free
vqc	free
vql	taken
vqe	free
vqh	free
vqj	free
vqd	free
vqk	free
vqf	free
vqg	free
vqi	free
vqn	free
vqp	free
vqm	free
vqr	free
vqq	free
vqo	free
vqt	free
vqv	free
vqs	free
vqu	free
vqy	free
vra	free
vqz	free
vqw	free
vrb	free
vqx	free
vre	free
vrc	free
vrf	free
vrd	free
vrm	taken
vrg	free
vri	free
vrj	free
vrl	free
vrk	free
vrh	free
vrt	taken
vrq	free
vrr	free
vrs	free
vry	taken
vru	free
vrv	free
vrn	free
vro	free
vrp	free
vrx	free
vsc	taken
vsd	taken
vse	taken
vsf	taken
vrw	free
vsl	taken
vrz	free
vsm	taken
vsb	free
vso	taken
vsh	free
vsi	free
vsj	free
vsa	free
vsk	free
vss	taken
vst	taken
vsn	free
vsg	free
vsp	free
vsr	free
vtc	taken
vsw	free
vsq	free
vtf	taken
vsv	free
vsu	free
vsy	free
vsx	free
vtd	free
vta	free
vsz	free
vtk	taken
vte	free
vtb	free
vtm	taken
vti	free
vtj	free
vts	taken
vto	free
vtg	free
vtq	free
vth	free
vtr	free
vtl	free
vtp	free
vtt	free
vtn	free
vub	taken
vuc	taken
vud	taken
vtv	free
vtx	free
vuf	taken
vue	taken
vui	taken
vua	free
vtu	free
vuk	taken
vtw	free
vum	taken
vty	free
vun	taken
vuo	taken
vtz	free
vup	taken
vuv	taken
vuj	free
vug	free
vuh	free
vuq	free
vus	free
vul	free
vvc	taken
vur	free
vut	free
vuu	free
vuy	free
vvf	taken
vuw	free
vuz	free
vvg	taken
vva	free
vvb	free
vvd	free
vux	taken
vvh	free
vvp	taken
vvl	free
vve	free
vvt	taken
vvo	free
vvi	free
vvj	free
vvk	free
vvm	free
vvv	taken
vvn	free
vvx	taken
vvq	free
vvr	free
vwe	free
vvw	free
vvy	free
vvs	free
vvz	free
vwb	free
vwd	free
vwa	free
vvu	free
vwc	free
vwh	free
vwi	free
vwl	free
vwm	free
vwp	taken
vwg	free
vwf	free
vwj	free
vwk	free
vwo	free
vwn	free
vwx	taken
vwt	free
vwv	free
vwq	free
vwr	free
vws	free
vwu	free
vwz	free
vxb	free
vww	free
vwy	free
vxd	free
vxa	free
vxe	free
vxc	free
vxi	free
vxj	free
vxk	free
vxf	free
vxg	free
vxh	free
vxl	free
vxq	taken
vxm	free
vxp	free
vxn	free
vxx	taken
vxr	free
vxs	free
vxu	free
vxv	free
vxo	free
vxw	free
vxt	free
vxy	free
vxz	free
vyb	free
vyd	free
vyf	free
vyg	free
vya	free
vyh	free
vyc	free
vye	free
vyk	free
vyn	free
vyi	free
vyj	free
vyo	free
vyp	free
vyq	free
vyl	free
vym	free
vys	free
vyt	free
vyr	free
vyv	free
vyw	free
vyy	free
vyz	free
vza	free
vyu	free
vzi	taken
vzb	free
vyx	free
vzd	free
vze	free
vzf	free
vzh	free
vzc	free
vzl	free
vzm	free
vzg	free
vzn	free
vzj	free
vzk	free
vzr	free
vzo	free
vzp	free
vzt	free
vzu	free
vzq	free
vzv	free
wab	taken
vzz	free
wac	taken
wad	taken
vzx	free
waf	taken
vzs	free
wag	taken
wai	taken
wal	taken
wam	taken
wan	taken
vzw	free
wao	taken
wap	taken
wae	free
vzy	free
war	taken
wah	free
was	taken
wat	taken
wau	taken
wav	taken
waw	taken
wak	free
wax	taken
way	taken
waa	free
wbc	taken
waj	free
waq	free
wbe	free
wbg	free
wba	free
waz	free
wbb	free
wbd	free
wbf	free
wbh	free
wbp	taken
wbo	free
wbn	free
wbt	taken
wbj	free
wbk	free
wbm	free
wbq	free
wbr	free
wbs	free
wbi	free
wbu	free
wcb	taken
wbv	free
wbl	free
wcc	taken
wce	taken
wbx	free
wcf	taken
wcd	free
wci	taken
wcj	taken
wbw	free
wck	taken
wcl	taken
wcm	taken
wby	free
wcr	taken
wcg	free
wbz	free
wcn	free
wca	free
wcs	taken
wct	taken
wcx	taken
wch	free
wcq	free
wco	free
wdd	taken
wcv	free
wcw	free
wcp	free
wdf	taken
wda	free
wcu	free
wdi	taken
wdb	free
wcy	free
wdc	free
wcz	free
wdk	taken
wdm	taken
wde	free
wdn	taken
wdg	free
wdr	taken
wds	taken
wdt	taken
wdj	free
wdu	taken
wdx	taken
wdo	free
wdp	free
wea	taken
wdq	free
wdh	free
web	taken
wed	taken
wee	taken
wdv	free
weg	taken
wdl	free
weh	taken
wdy	free
wei	taken
wdz	free
wek	taken
wen	taken
wdw	free
wer	taken
wet	taken
wej	free
wec	free
wel	free
weu	taken
weo	free
wef	free
wew	taken
weq	free
wex	taken
wem	free
wep	free
wfd	free
wes	free
wez	free
wfa	free
wfh	taken
wev	free
wey	free
wff	free
wfc	free
wfb	free
wfm	taken
wfe	free
wfi	free
wfk	free
wfg	free
wfs	taken
wfn	free
wfo	free
wfl	free
wfr	free
wfj	free
wfu	free
wfq	free
wga	taken
wfx	free
wfv	free
wfy	free
wfz	free
wfw	free
wfp	free
wgb	free
wft	free
wgc	free
wgd	taken
wgf	taken
wgo	taken
wgh	free
wgl	free
wgm	free
wgq	taken
wgp	free
wgj	free
wgk	free
wgi	free
wge	free
wgg	free
wgn	free
wgs	free
wgr	free
wha	taken
wgt	free
wgv	free
wgw	free
wgy	free
wgz	free
wgu	free
whd	free
wgx	free
whe	free
whf	free
whb	free
whh	free
whc	free
who	taken
whq	taken
whj	free
whl	free
whg	free
whs	taken
whi	free
whn	free
whp	free
whk	free
whm	free
why	taken
whr	free
wia	taken
wic	taken
wid	taken
whx	free
whw	free
wif	taken
wig	taken
wih	taken
wii	taken
wht	free
whu	free
whv	free
wil	taken
win	taken
wim	taken
wib	free
wio	taken
wip	taken
wis	taken
wit	taken
whz	free
wij	free
wik	free
wix	taken
wie	free
wiz	taken
wiq	free
wiu	free
wiw	free
wjf	taken
wir	free
wjb	free
wja	free
wiv	free
wjj	taken
wjl	taken
wiy	free
wjc	free
wjd	free
wjh	free
wje	free
wjq	taken
wjk	free
wjs	taken
wjm	free
wjg	free
wjn	free
wjo	free
wji	free
wjw	taken
wjz	taken
wjr	free
wjt	free
wjp	free
wkb	free
wju	free
wkc	free
wjv	free
wjx	free
wjy	free
wke	free
wka	free
wkf	free
wkd	free
wkj	free
wkm	free
wkl	free
wko	free
wkg	free
wkh	free
wki	free
wkr	taken
wkp	free
wkx	taken
wkk	free
wkn	free
wkq	free
wks	free
wlb	free
wkt	free
wku	free
wkv	free
wkw	free
wky	free
wkz	free
wla	free
wlf	taken
wle	free
wlg	free
wli	free
wlk	free
wll	free
wlq	taken
wld	free
wlh	free
wlc	free
wlj	free
wls	taken
wlm	free
wlt	taken
wlu	free
wlo	free
wln	free
wlr	free
wma	taken
wmd	taken
wlp	free
wlx	free
wmf	taken
wlz	free
wly	free
wmg	taken
wmi	taken
wlv	free
wmj	taken
wmb	free
wmc	free
wlw	free
wml	taken
wms	taken
wmh	free
wme	free
wmk	free
wmu	taken
wmv	taken
wmo	free
wmq	free
wmr	free
wmy	taken
wmw	free
wmm	free
wmn	free
wmp	free
wmt	free
wnd	free
wmx	free
wne	free
wmz	free
wna	free
wnb	free
wnc	free
wno	taken
wnf	free
wng	free
wni	free
wnp	taken
wns	taken
wnk	free
wnh	free
wnl	free
wnm	free
wnj	free
wnq	free
wnn	free
wnt	free
woa	taken
wnu	free
wnv	free
wnw	free
wob	taken
wny	free
wod	taken
wnr	free
wog	taken
wnx	free
wok	taken
wol	taken
won	taken
woo	taken
wnz	free
woe	free
wof	free
wop	taken
woh	free
wot	taken
woc	free
woi	free
wox	taken
wow	taken
woj	free
woy	taken
woz	taken
wos	free
wom	free
wpc	taken
wov	free
woq	free
wpg	taken
wou	free
wpd	free
wpk	taken
wpf	free
wor	free
wpl	taken
wpa	free
wpm	taken
wpo	taken
wpb	free
wpp	taken
wpe	free
wps	taken
wpt	taken
wph	free
wpi	free
wpw	taken
wpx	taken
wpj	free
wpn	free
wpz	taken
wpu	free
wpr	free
wpq	free
wpv	free
wpy	free
wqf	free
wqb	free
wqa	free
wqc	free
wqd	free
wqe	free
wql	taken
wqh	free
wqg	free
wqq	taken
wqn	free
wqm	free
wqi	free
wqo	free
wqp	free
wqj	free
wqk	free
wqr	free
wqu	free
wqv	free
wqs	free
wqt	free
wqw	free
wqy	free
wqz	free
wrg	taken
wra	free
wqx	free
wrk	taken
wrb	free
wre	free
wrd	free
wrp	taken
wrc	free
wrj	free
wrf	free
wrl	free
wrr	taken
wrm	free
wrh	free
wri	free
wrt	taken
wru	taken
wro	free
wrn	free
wrs	free
wsc	taken
wrq	free
wrv	free
wsd	taken
wry	free
wrx	free
wsf	taken
wsb	free
wsa	free
wsg	taken
wsh	taken
wsj	taken
wsk	taken
wrw	free
wsm	taken
wrz	free
wsp	taken
wsq	taken
wss	taken
wst	taken
wse	free
wsw	taken
wsi	free
wsx	taken
wsl	free
wsn	free
wso	free
wta	taken
wsr	free
wtc	taken
wtd	taken
wsu	free
wtf	taken
wth	taken
wsy	free
wsz	free
wtb	free
wsv	free
wtn	taken
wto	taken
wtp	taken
wts	taken
wtk	free
wte	free
wtm	free
wti	free
wtg	free
wtt	taken
wtj	free
wtq	free
wtr	free
wtl	free
wub	taken
wtu	free
wtw	free
wtx	free
wua	free
wui	taken
wtv	free
wuc	free
wtz	free
wty	free
wuh	free
wue	free
wud	free
wuf	free
wup	taken
wul	free
wug	free
wut	taken
wuu	taken
wun	free
wuj	free
wuk	free
wux	taken
wum	free
wur	free
wus	free
wuo	free
wuv	free
wuq	free
wva	free
wuw	free
wuy	free
wvb	free
wuz	free
wve	free
wvd	free
wvf	free
wvc	free
wvh	free
wvg	free
wvj	free
wvl	free
wvi	free
wvk	free
wvm	free
wvp	free
wvr	free
wvt	free
wvo	free
wvn	free
wvq	free
wvu	free
wvv	free
wvs	free
wvw	free
wwa	free
wwb	free
wvy	free
wvx	free
wwf	free
wwc	free
wwe	free
wwd	free
wwm	taken
wvz	free
wwp	taken
wwh	free
wwi	free
wwl	free
wwj	free
wwg	free
wwn	free
www	taken
wwk	free
wwq	free
wwx	taken
wxa	taken
wwo	free
wws	free
wwt	free
wwu	free
wwv	free
wwr	free
wxf	taken
wwy	free
wwz	free
wxc	free
wxm	taken
wxe	free
wxb	free
wxk	free
wxj	free
wxi	free
wxd	free
wxg	free
wxr	taken
wxh	free
wxs	taken
wxq	taken
wxl	free
wxo	free
wxn	free
wxp	free
wxw	free
wxx	free
wyb	taken
wyd	taken
wye	taken
wxz	free
wxt	free
wxu	free
wyg	taken
wxv	free
wxy	free
wyc	free
wyh	free
wya	free
wyl	free
wyk	free
wym	free
wyf	free
wyi	free
wyu	taken
wyj	free
wyn	free
wyr	free
wyo	free
wyt	free
wyv	free
wyw	free
wyp	free
wyq	free
wyx	free
wyy	free
wys	free
wzc	free
wzd	free
wze	free
wzf	free
wyz	free
wza	free
wzi	free
wzb	free
wzl	taken
wzh	free
wzg	free
wzj	free
wzo	free
wzk	free
wzm	free
wzr	free
wzn	free
wzt	free
wzu	free
wzp	free
wzq	free
wzs	free
wzw	free
xaa	free
wzv	free
xab	free
xac	free
wzx	free
wzy	free
xai	taken
wzz	free
xam	taken
xag	free
xad	free
xae	free
xap	taken
xar	taken
xak	free
xal	free
xaf	free
xah	free
xan	free
xao	free
xaj	free
xaq	free
xas	free
xau	free
xav	free
xaw	free
xax	free
xay	free
xba	free
xat	free
xbb	free
xbi	taken
xaz	free
xbe	free
xbn	taken
xbc	free
xbd	free
xbj	free
xbf	free
xbl	free
xbg	free
xbh	free
xbt	taken
xbk	free
xbw	taken
xbp	free
xbq	free
xbm	free
xbr	free
xbs	free
xcb	taken
xbo	free
xbv	free
xby	free
xbu	free
xca	free
xcc	free
xbx	free
xce	free
xcg	free
xbz	free
xcd	free
xci	free
xcf	free
xcp	taken
xcl	free
xcm	free
xch	free
xcj	free
xcv	taken
xck	free
xcq	free
xcx	taken
xcr	free
xcn	free
xco	free
xct	free
xdb	taken
xcu	free
xdc	taken
xde	taken
xcw	free
xdg	taken
xdf	taken
xcs	free
xcy	free
xdk	taken
xdl	taken
xda	free
xdd	free
xdo	taken
xdh	free
xcz	free
xdr	taken
xdi	free
xdj	free
xdt	taken
xdp	free
xdq	free
xdm	free
xdn	free
xdu	free
xdv	free
xdw	free
xec	taken
xed	taken
xds	free
xei	taken
xdx	free
xdy	free
xee	free
xdz	free
xea	free
xel	taken
xeb	free
xem	taken
xeo	taken
xes	taken
xef	free
xeg	free
xeh	free
xek	free
xet	taken
xev	taken
xej	free
xex	taken
xep	free
xfc	taken
xen	free
xeu	free
xer	free
xeq	free
xfe	taken
xey	free
xew	free
xfd	free
xfa	free
xez	free
xfb	free
xfi	free
xfj	free
xff	free
xfh	free
xfg	free
xfs	taken
xft	taken
xfp	free
xfk	free
xfl	free
xfr	free
xfn	free
xfm	free
xfx	taken
xfo	free
xfu	free
xfq	free
xfw	free
xfv	free
xgc	free
xge	free
xfy	free
xfz	free
xga	free
xgb	free
xgg	free
xgd	free
xgo	taken
xgf	free
xgh	free
xgi	free
xgj	free
xgl	free
xgm	free
xgp	free
xgk	free
xgt	free
xgn	free
xgr	free
xgq	free
xgs	free
xgu	free
xgy	free
xgv	free
xgw	free
xgx	free
xhb	free
xgz	free
xha	free
xhf	free
xhg	free
xhc	free
xhh	free
xhd	free
xhe	free
xhr	taken
xhi	free
xhs	taken
xhk	free
xhj	free
xhp	free
xhl	free
xhm	free
xhx	taken
xhn	free
xho	free
xhq	free
xid	taken
xie	taken
xht	free
xhu	free
xia	free
xhv	free
xhw	free
xib	free
xhy	free
xik	taken
xhz	free
xim	taken
xin	taken
xic	free
xio	taken
xih	free
xir	taken
xit	taken
xif	free
xiu	taken
xig	free
xii	free
xij	free
xil	free
xip	free
xis	free
xiq	free
xiw	free
xix	free
xiv	free
xjc	free
xiy	free
xja	free
xiz	free
xjj	taken
xjf	free
xjb	free
xjd	free
xje	free
xjh	free
xjg	free
xjs	taken
xjk	free
xjl	free
xjp	free
xji	free
xjq	free
xjm	free
xjo	free
xjn	free
xjv	free
xjr	free
xjx	free
xjt	free
xju	free
xjw	free
xjy	free
xkc	free
xjz	free
xke	free
xka	free
xkb	free
xkg	free
xkd	free
xkh	free
xkf	free
xkl	free
xki	free
xkm	free
xkn	free
xkj	free
xkk	free
xkq	free
xkr	free
xko	free
xks	free
xkp	free
xkw	free
xky	free
xkt	free
xku	free
xkv	free
xkx	free
xlh	taken
xli	taken
xld	free
xkz	free
xla	free
xlb	free
xlc	free
xln	taken
xlf	free
xlr	taken
xle	free
xls	taken
xlg	free
xlo	free
xlp	free
xlq	free
xlj	free
xlk	free
xlx	taken
xll	free
xlm	free
xlt	free
xmc	taken
xlu	free
xmd	taken
xlw	free
xlz	free
xmb	free
xlv	free
xml	taken
xme	free
xmf	free
xmh	free
xmg	free
xly	free
xma	free
xmm	taken
xmi	free
xmr	taken
xms	taken
xmk	free
xmn	free
xmx	taken
xmj	free
xmo	free
xmp	free
xmq	free
xmu	free
xmv	free
xmw	free
xnf	taken
xmt	free
xmy	free
xmz	free
xna	free
xnd	free
xnh	free
xnc	free
xnb	free
xne	free
xnj	free
xng	free
xni	free
xnk	free
xnl	free
xnm	free
xnp	free
xnt	taken
xnq	free
xnn	free
xno	free
xoa	taken
xnr	free
xnu	free
xnv	free
xns	free
xnx	free
xnw	free
xnz	free
xof	free
xog	free
xok	taken
xob	free
xod	free
xon	taken
xoi	free
xny	free
xoe	free
xoc	free
xoo	taken
xoh	free
xor	taken
xow	taken
xox	taken
xoj	free
xop	free
xol	free
xou	free
xom	free
xoq	free
xos	free
xot	free
xov	free
xoy	free
xoz	free
xpa	free
xpi	taken
xpc	free
xpm	taken
xpb	free
xpd	free
xpj	free
xpk	free
xpp	taken
xpe	free
xpl	free
xps	taken
xpf	free
xph	free
xpg	free
xpn	free
xpo	free
xpq	free
xpu	free
xpv	free
xpw	free
xpx	free
xpz	free
xpr	free
xpt	free
xqb	free
xpy	free
xqa	free
xqd	free
xqe	free
xql	taken
xqc	free
xqh	free
xqi	free
xqj	free
xqq	taken
xqf	free
xqg	free
xqm	free
xqn	free
xqk	free
xqs	free
xqt	free
xqo	free
xqp	free
xqr	free
xqw	free
xqu	free
xqv	free
xqz	free
xqx	free
xqy	free
xrb	free
xrc	free
xrd	free
xrk	taken
xra	free
xrf	free
xrm	taken
xrp	taken
xri	free
xrh	free
xre	free
xrj	free
xrl	free
xrg	free
xro	free
xrr	free
xrn	free
xrt	free
xru	free
xrv	free
xrq	free
xsd	taken
xrs	free
xrx	free
xrw	free
xsb	free
xry	free
xse	free
xsf	free
xrz	free
xsc	free
xsa	free
xsp	taken
xsg	free
xsk	free
xsh	free
xsm	free
xsr	taken
xsi	free
xss	taken
xsn	free
xsj	free
xst	taken
xso	free
xsl	free
xsy	taken
xsq	free
xtc	taken
xsv	free
xsx	free
xsw	free
xsz	free
xta	free
xsu	free
xtf	free
xtb	free
xtl	taken
xtn	taken
xte	free
xtd	free
xth	free
xto	taken
xtj	free
xtr	taken
xts	taken
xtg	free
xti	free
xtm	free
xtx	taken
xtk	free
xtq	free
xtt	free
xtv	free
xtw	free
xtp	free
xue	taken
xty	free
xtu	free
xub	free
xui	taken
xuc	free
xtz	free
xul	taken
xuf	free
xua	free
xun	taken
xup	taken
xud	free
xug	free
xum	free
xuh	free
xuj	free
xuk	free
xuq	free
xur	free
xux	taken
xus	free
xuo	free
xuu	free
xuv	free
xuw	free
xut	free
xuz	free
xuy	free
xvb	free
xvd	free
xva	free
xve	free
xvc	free
xvg	free
xvm	taken
xvi	free
xvk	free
xvf	free
xvh	free
xvj	free
xvt	taken
xvn	free
xvp	free
xvq	free
xvr	free
xvx	taken
xvl	free
xvo	free
xvv	free
xvw	free
xvs	free
xwa	free
xvu	free
xwc	free
xvz	free
xvy	free
xwe	free
xwb	free
xwd	free
xwf	free
xwg	free
xwk	free
xwi	free
xwm	free
xwh	free
xwj	free
xwl	free
xwn	free
xwp	free
xwo	free
xwr	free
xwt	free
xwv	free
xxb	taken
xwq	free
xxd	taken
xwx	free
xwu	free
xws	free
xxh	taken
xww	free
xwy	free
xwz	free
xxe	free
xxa	free
xxl	taken
xxg	free
xxc	free
xxk	free
xxf	free
xxs	taken
xxi	free
xxm	free
xxn	free
xxj	free
xxp	free
xxr	free
xxx	taken
xxo	free
xxq	free
xxu	free
xyd	taken
xye	taken
xxy	free
xxt	free
xyb	free
xxw	free
xxv	free
xyc	free
xya	free
xxz	free
xyk	taken
xyf	free
xyh	free
xyr	taken
xyg	free
xym	free
xyl	free
xyi	free
xyj	free
xyo	free
xyu	taken
xyp	free
xyx	taken
xyy	taken
xyz	taken
xyn	free
xys	free
xyq	free
xyw	free
xyt	free
xzd	free
xze	free
xzk	taken
xyv	free
xzi	free
xza	free
xzc	free
xzb	free
xzg	free
xzf	free
xzh	free
xzl	free
xzj	free
xzn	free
xzo	free
xzv	free
xzp	free
xzt	free
yaa	taken
xzm	free
xzr	free
xzs	free
yab	taken
xzq	free
yac	taken
yad	taken
yae	taken
yaf	taken
xzx	free
yag	taken
xzw	free
xzz	free
xzy	free
xzu	free
yah	taken
yai	taken
yak	taken
yam	taken
yal	taken
yao	taken
yap	taken
yaq	taken
yar	taken
yan	taken
yas	taken
yat	taken
yav	taken
yax	taken
yaw	taken
yay	taken
yaj	free
yaz	free
yau	free
ybd	free
ybf	free
ybh	free
ybb	free
yba	free
ybc	free
ybe	free
ybg	free
ybm	taken
ybi	free
ybp	free
ybl	free
ybk	free
ybr	free
ybn	free
ybq	free
ybo	free
ybj	free
ybw	taken
ybs	free
ycb	taken
ybt	free
ybu	free
ybv	free
yby	free
ybz	free
ycf	taken
yci	taken
ycc	free
yce	free
yca	free
ybx	free
ycd	free
ycp	taken
ych	free
ycg	free
ycj	free
yck	free
ycq	free
ycl	free
ycm	free
ycn	free
ycu	free
yco	free
ycr	free
ycs	free
yct	free
ycv	free
ycx	free
ycz	free
ycw	free
ydd	free
ycy	free
yda	free
ydc	free
ydb	free
ydg	free
ydl	taken
ydm	taken
ydh	free
yde	free
ydj	free
ydf	free
yds	free
ydi	free
ydp	free
ydq	free
ydk	free
ydo	free
ydn	free
yea	taken
ydr	free
ydw	free
ydx	free
yec	taken
ydt	free
ydu	free
ydy	free
yee	taken
yeh	taken
ydv	free
yeb	free
yek	taken
yel	taken
ydz	free
yeo	taken
yen	taken
yed	free
yep	taken
yef	free
yes	taken
yej	free
yet	taken
yew	taken
yeg	free
yez	taken
yei	free
yev	free
yem	free
yex	free
yeq	free
yer	free
yeu	free
yey	free
yfe	free
yff	free
yfa	free
yfb	free
yfc	free
yfi	free
yfm	taken
yfd	free
yfj	free
yfg	free
yfh	free
yfl	free
yfn	free
yfo	free
yfq	free
yfr	free
yfk	free
yfs	free
yft	free
yfu	free
yfp	free
yfv	free
ygf	taken
ygg	taken
yfw	free
ygc	free
yfx	free
ygh	taken
yfy	free
yfz	free
yga	free
ygb	free
ygd	free
yge	free
ygi	free
ygj	free
ygs	taken
ygo	free
ygl	free
ygk	free
ygr	free
ygm	free
ygn	free
ygt	free
ygp	free
ygq	free
yhd	taken
ygv	free
ygu	free
yhb	free
ygw	free
yhh	taken
ygx	free
ygy	free
ygz	free
yha	free
yhc	free
yhe	free
yhk	free
yhf	free
yhg	free
yhr	taken
yho	free
yhj	free
yhi	free
yhm	free
yhl	free
yht	taken
yhn	free
yhx	taken
yia	taken
yhp	free
yhu	free
yhv	free
yhq	free
yhy	free
yhz	free
yhs	free
yib	free
yii	taken
yhw	free
yil	taken
yin	taken
yic	free
yih	free
yid	free
yio	taken
yie	free
yim	free
yif	free
yit	taken
yig	free
yij	free
yik	free
yiz	taken
yiq	free
yis	free
yiu	free
yip	free
yix	free
yir	free
yiv	free
yjb	free
yiw	free
yjc	free
yiy	free
yjd	free
yjl	taken
yja	free
yje	free
yjh	free
yji	free
yjk	free
yjf	free
yjg	free
yjs	taken
yjn	free
yjp	free
yjj	free
yjm	free
yjy	taken
yjo	free
yjz	taken
yjr	free
yju	free
yjq	free
yjx	free
yjt	free
yjw	free
yjv	free
yka	free
ykc	free
yke	free
ykk	taken
ykf	free
ykb	free
ykd	free
ykg	free
ykm	free
ykn	free
ykh	free
yki	free
ykj	free
ykp	free
ykl	free
yko	free
yky	taken
ykr	free
yks	free
ykq	free
ylc	taken
ykw	free
yld	taken
ykt	free
yku	free
ykz	free
ylb	free
ykv	free
ykx	free
yla	free
yli	free
yle	free
ylg	free
ylf	free
ylh	free
ylj	free
ylk	free
yln	free
yll	free
ylm	free
ylo	free
ylp	free
ylr	free
ylq	free
ylx	free
yly	free
yls	free
ylt	free
ylv	free
ymb	taken
ymd	taken
ylu	free
ylw	free
yme	taken
yml	taken
ylz	free
yma	free
ymg	free
ymk	free
ymj	free
ymc	free
ymf	free
yms	taken
ymh	free
ymi	free
ymt	taken
ymm	free
ymr	free
ymq	free
ymn	free
ymo	free
ymp	free
ync	taken
ymv	free
ymw	free
ymy	free
ymu	free
ymx	free
ynd	free
yne	free
ynf	free
ymz	free
yna	free
ynb	free
yno	taken
ynp	taken
yni	free
yng	free
yns	taken
ynk	free
ynh	free
ynl	free
ynn	free
ynj	free
ynq	free
ynr	free
ynm	free
ynw	free
ynx	free
yod	taken
ynt	free
ynu	free
yog	taken
ynv	free
yob	free
yoc	free
yny	free
yoi	taken
ynz	free
yol	taken
yoe	free
yoa	free
yom	taken
yon	taken
yoo	taken
yoh	free
yop	taken
yos	taken
you	taken
yov	taken
yow	taken
yox	taken
yof	free
yoy	taken
yoq	free
yoj	free
yok	free
yor	free
yot	free
ypa	free
ypb	free
yoz	free
ypc	free
ypd	free
ypf	free
ype	free
ypg	free
ypm	taken
ypj	free
ypk	free
ypp	taken
yps	taken
yph	free
ypi	free
ypn	free
ypr	free
ypo	free
ypl	free
ypt	free
ypu	free
ypv	free
yqb	taken
ypq	free
ypw	free
ypx	free
yqd	free
ypy	free
yqe	free
yqa	free
ypz	free
yql	taken
yqc	free
yqf	free
yqg	free
yqi	free
yqh	free
yqm	free
yqp	free
yqj	free
yqk	free
yqq	free
yqt	free
yqn	free
yqo	free
yqz	taken
yqu	free
yqr	free
yqs	free
yqw	free
yrd	taken
yqy	free
yqv	free
yqx	free
yra	free
yrb	free
yrh	free
yrc	free
yri	free
yrm	taken
yrn	taken
yrf	free
yre	free
yrg	free
yrs	taken
yrj	free
yro	free
yrw	taken
yrk	free
yrq	free
yrt	free
yrl	free
yrp	free
yrr	free
yrx	free
yru	free
yry	free
yrv	free
ysa	free
ysf	taken
ysg	taken
ysb	free
ysh	taken
yrz	free
ysc	free
ysi	free
ysd	free
yse	free
ysk	free
ysn	free
ysj	free
ysl	free
ysm	free
ysp	free
ysq	free
ysr	free
yso	free
yta	taken
ytc	taken
ysu	free
yss	free
yst	free
ysv	free
ytd	taken
ysz	free
ysw	free
ysx	free
ysy	free
ytf	free
ytb	free
ytg	free
yti	free
ytj	free
ytp	taken
yte	free
ytk	free
yts	taken
yth	free
ytl	free
ytm	free
ytn	free
ytx	taken
ytt	free
yto	free
ytq	free
yua	taken
ytr	free
yub	taken
yue	taken
ytu	free
ytv	free
ytw	free
yuh	taken
yui	taken
yty	free
yuk	taken
ytz	free
yuc	free
yum	taken
yun	taken
yud	free
yup	taken
yus	taken
yug	free
yuf	free
yuo	free
yuq	free
yut	free
yuu	free
yuj	free
yul	free
yur	free
yux	free
yuy	free
yuv	free
yuz	free
yva	free
yvc	free
yvd	free
yuw	free
yve	free
yvm	taken
yvb	free
yvi	free
yvh	free
yvk	free
yvl	free
yvr	taken
yvf	free
yvg	free
yvo	free
yvp	free
yvj	free
yvn	free
yvu	free
yvx	free
yvq	free
yvs	free
yvt	free
yvv	free
yvw	free
yvy	free
yvz	free
ywa	free
ywe	free
ywf	free
ywb	free
ywc	free
ywd	free
ywi	free
ywj	free
ywo	taken
ywh	free
ywg	free
ywk	free
ywl	free
yws	free
ywm	free
ywn	free
ywp	free
ywq	free
yww	free
ywr	free
ywt	free
ywu	free
ywv	free
ywx	free
ywy	free
yxh	taken
yxb	free
yxc	free
yxl	taken
ywz	free
yxe	free
yxa	free
yxf	free
yxd	free
yxg	free
yxi	free
yxn	free
yxj	free
yxq	free
yxk	free
yxm	free
yxo	free
yxp	free
yxr	free
yxt	free
yxu	free
yxv	free
yxs	free
yxy	free
yxw	free
yyf	taken
yxx	free
yyc	free
yyh	taken
yyj	taken
yxz	free
yya	free
yyl	taken
yyb	free
yyd	free
yye	free
yyi	free
yyg	free
yyn	free
yyo	free
yyq	free
yyk	free
yym	free
yyx	taken
yyt	free
yyy	taken
yyp	free
yzb	taken
yyu	free
yyr	free
yys	free
yyw	free
yzh	taken
yyv	free
yzd	free
yyz	free
yza	free
yzc	free
yzf	free
yzi	free
yze	free
yzg	free
yzk	free
yzr	taken
yzl	free
yzj	free
yzt	taken
yzp	free
yzq	free
yzn	free
yzo	free
yzm	free
zab	taken
yzv	free
yzu	free
yzx	free
yzs	free
zaf	taken
zag	taken
yzw	free
zaa	free
zac	free
zam	taken
zad	free
yzy	free
yzz	free
zan	taken
zap	taken
zao	taken
zaq	taken
zaj	free
zae	free
zal	free
zah	free
zai	free
zax	taken
zaz	taken
zak	free
zau	free
zar	free
zas	free
zat	free
zba	free
zav	free
zaw	free
zay	free
zbb	free
zbc	free
zbd	free
zbe	free
zbf	free
zbh	free
zbg	free
zbl	free
zbi	free
zbj	free
zbr	taken
zbk	free
zbo	free
zbm	free
zbn	free
zbp	free
zbq	free
zbu	free
zbw	free
zcc	taken
zbs	free
zbv	free
zby	free
zbt	free
zbx	free
zce	taken
zbz	free
zcb	free
zcj	taken
zcm	taken
zco	taken
zca	free
zcg	free
zcr	taken
zcd	free
zch	free
zcf	free
zci	free
zcl	free
zcq	free
zck	free
zcw	taken
zcn	free
zdb	taken
zcp	free
zct	free
zcv	free
zcz	free
zdf	taken
zda	free
zcs	free
zcu	free
zcx	free
zcy	free
zdc	free
zdg	free
zdd	free
zde	free
zdi	free
zdp	taken
zdl	free
zdh	free
zdj	free
zdk	free
zdn	free
zdm	free
zdq	free
zdr	free
zdy	taken
zdt	free
zdo	free
zdv	free
zed	taken
zdx	free
zds	free
zee	taken
zdz	free
zdu	free
zeh	taken
zeb	free
zel	taken
zdw	free
zec	free
zea	free
zen	taken
zeo	taken
zep	taken
zef	free
zeg	free
zer	taken
zei	free
zeq	free
zej	free
zek	free
zes	free
zet	free
zem	free
zev	free
zew	free
zeu	free
zex	free
zfb	free
zey	free
zfa	free
zfc	free
zfe	free
zez	free
zfd	free
zff	free
zfg	free
zfk	free
zfm	free
zfh	free
zfj	free
zfn	free
zfi	free
zfs	taken
zfl	free
zfo	free
zfq	free
zfp	free
zfu	free
zgb	taken
zfr	free
zfw	free
zft	free
zfv	free
zfx	free
zfy	free
zfz	free
zge	free
zgf	free
zga	free
zgg	free
zgc	free
zgd	free
zgi	free
zgj	free
zgh	free
zgk	free
zgl	free
zgo	free
zgn	free
zgm	free
zgq	free
zgr	free
zgs	free
zhb	taken
zgt	free
zgp	free
zgu	free
zhc	taken
zgv	free
zgx	free
zgw	free
zgy	free
zhd	free
zhe	free
zhi	taken
zgz	free
zha	free
zhh	free
zhf	free
zhg	free
zho	taken
zhp	taken
zhl	free
zhk	free
zhs	taken
zhn	free
zht	taken
zhu	taken
zhx	taken
zhy	taken
zhj	free
zhm	free
zid	taken
zif	taken
zhr	free
zig	taken
zhq	free
zic	free
zhw	free
zie	free
zhv	free
zhz	free
zim	taken
zia	free
zib	free
zin	taken
zip	taken
zir	taken
zis	taken
zij	free
zit	taken
zik	free
zih	free
zii	free
zio	free
zil	free
zix	free
ziq	free
ziz	free
ziu	free
zja	free
ziv	free
ziw	free
zjb	free
ziy	free
zjf	free
zjc	free
zjh	free
zji	free
zjj	free
zjd	free
zjk	free
zje	free
zjl	free
zjq	taken
zjs	taken
zjt	taken
zjg	free
zjw	taken
zjx	taken
zjy	taken
zjp	free
zjr	free
zjv	free
zjm	free
zjn	free
zjo	free
zjz	free
zka	free
zkb	free
zju	free
zkd	free
zkf	free
zkh	free
zkc	free
zki	free
zke	free
zkg	free
zkk	free
zkj	free
zkl	free
zkn	free
zkm	free
zkq	free
zkr	free
zks	free
zkp	free
zko	free
zkv	free
zld	taken
zkt	free
zkw	free
zku	free
zla	free
zlc	free
zkx	free
zky	free
zkz	free
zlm	taken
zlb	free
zle	free
zlo	taken
zlh	free
zlk	free
zlf	free
zlg	free
zlj	free
zli	free
zll	free
zln	free
zlt	free
zlu	free
zlv	free
zlx	free
zls	free
zmd	taken
zlw	free
zlp	free
zlq	free
zly	free
zlr	free
zma	free
zlz	free
zml	taken
zmf	free
zmb	free
zmc	free
zmg	free
zmh	free
zmi	free
zmj	free
zmq	taken
zme	free
zmk	free
zms	free
zmm	free
zmn	free
zmo	free
zmp	free
zmr	free
zmu	free
zmt	free
zmv	free
zmy	taken
zmw	free
znc	free
zne	free
znd	free
zng	free
zna	free
zmx	free
znb	free
zmz	free
znf	free
zni	free
znj	free
znp	free
zno	free
znk	free
znq	free
znm	free
znh	free
znn	free
znl	free
zoa	taken
znr	free
znv	free
znu	free
znx	free
znz	free
zoe	taken
znt	free
zog	taken
zob	free
zns	free
znw	free
zny	free
zoi	taken
zoc	free
zon	taken
zod	free
zof	free
zom	taken
zoo	taken
zoh	free
zor	taken
zos	taken
zou	taken
zoj	free
zow	taken
zol	free
zoq	free
zot	free
zok	free
zox	free
zoy	free
zop	free
zpb	free
zpa	free
zov	free
zoz	free
zpl	taken
zpf	free
zpg	free
zpc	free
zpi	free
zpm	taken
zpd	free
zpe	free
zpt	taken
zph	free
zpj	free
zpn	free
zpk	free
zpu	free
zpq	free
zpp	free
zpo	free
zpr	free
zpx	free
zps	free
zpy	free
zpv	free
zpw	free
zqa	free
zqb	free
zqc	free
zqe	free
zqg	free
zpz	free
zqh	free
zqd	free
zqf	free
zqi	free
zql	free
zqs	taken
zqm	free
zqj	free
zqo	free
zqp	free
zqk	free
zqr	free
zqn	free
zqt	free
zqv	free
zqq	free
zrc	taken
zqw	free
zqu	free
zqy	free
zqx	free
zqz	free
zra	free
zre	free
zrb	free
zrh	free
zrd	free
zrf	free
zrg	free
zri	free
zrk	free
zrj	free
zro	free
zrp	free
zrm	free
zrl	free
zrq	free
zrn	free
zrx	taken
zrr	free
zrs	free
zru	free
zrw	free
zrt	free
zrv	free
zsh	taken
zry	free
zrz	free
zsc	free
zsa	free
zse	free
zsd	free
zsb	free
zsg	free
zsf	free
zsj	free
zsi	free
zsn	free
zso	free
zsp	free
zss	taken
zsq	free
zst	taken
zsm	free
zsl	free
zsk	free
zsu	free
zsv	free
zsw	free
zsr	free
zsx	free
zsy	free
zsz	free
zta	free
ztd	free
zte	free
ztb	free
ztc	free
ztg	free
ztf	free
zth	free
zti	free
ztm	free
ztn	free
ztp	free
ztj	free
zto	free
ztk	free
ztl	free
ztq	free
ztt	free
ztv	free
ztw	free
ztr	free
zty	free
zts	free
ztu	free
ztx	free
zug	taken
zua	free
zui	taken
zuc	free
zud	free
ztz	free
zum	taken
zun	taken
zuo	taken
zub	free
zup	taken
zuh	free
zue	free
zuf	free
zul	free
zut	taken
zuj	free
zuq	free
zuk	free
zur	free
zus	free
zuu	free
zux	free
zuv	free
zuw	free
zuy	free
zvd	free
zuz	free
zvh	free
zva	free
zvb	free
zvc	free
zve	free
zvf	free
zvj	free
zvg	free
zvo	free
zvi	free
zvp	free
zvk	free
zvl	free
zvq	free
zvm	free
zvn	free
zvu	free
zvt	free
zvr	free
zvx	free
zvy	free
zvz	free
zvs	free
zvv	free
zvw	free
zwc	free
zwd	free
zwa	free
zwe	free
zwg	free
zwb	free
zwh	free
zwf	free
zwq	taken
zwk	free
zwl	free
zws	taken
zwn	free
zwi	free
zwj	free
zww	taken
zwm	free
zwy	taken
zwt	free
zwr	free
zwo	free
zwu	free
zwp	free
zxc	taken
zwv	free
zxf	taken
zwx	free
zwz	free
zxa	free
zxb	free
zxl	taken
zxm	taken
zxe	free
zxo	taken
zxh	free
zxg	free
zxj	free
zxi	free
zxq	taken
zxt	taken
zxd	free
zxx	taken
zxy	taken
zxp	free
zxk	free
zxr	free
zxs	free
zyb	taken
zxv	free
zyc	taken
zxn	free
zxu	free
zxw	free
zyj	taken
zya	free
zxz	free
zyi	free
zyh	free
zyd	free
zyf	free
zye	free
zyg	free
zyl	free
zys	taken
zyp	free
zyk	free
zym	free
zyn	free
zyo	free
zyw	taken
zyx	taken
zyy	taken
zyr	free
zyq	free
zyt	free
zzf	taken
zyu	free
zyv	free
zzh	taken
zzg	taken
zyz	free
zza	free
zzb	free
zzd	free
zze	free
zzi	free
zzj	free
zzc	free
zzk	free
zzl	free
zzm	free
zzr	taken
zzs	taken
zzt	taken
zzo	free
zzw	taken
zzq	free
zzy	taken
zzz	taken
zzn	free
zzp	free
zzu	free
zzv	free
zzx	free
